anli	fu'ivla      \nx_1 is a ring with inside diameter x_2, outside diameter x_3
aski	fu'ivla      \nx_1 (ordered set of numerals) represents x_2 (text) in ASCII encoding
bacru	gismu   \n-ba'u-      \nx_1 utters x_2
badna	gismu      \nx_1 is a banana fruit or plant of species x_2
badri	gismu   \n-dri-      \nx_1 is sad about x_2
bajra	gismu   \n-baj-      \nx_1 runs on x_2 using limbs x_3 with gait x_4
bakfu	gismu   \n-baf-      \nx_1 is a pack or bundle containing x_2 held together by x_3
bakni	gismu   \n-bak-      \nx_1 is a cow or bovine of species x_2
bakri	gismu      \nx_1 is chalk from x_2 in the form of x_3
baktu	gismu      \nx_1 is a pail or bucket containing x_2 made of material x_3
balji	gismu      \nx_1 is a plant bulb of species x_2
balni	gismu      \nx_1 is a balcony or shelf of structure x_2
balre	gismu   \n-ba'e-      \nx_1 is a blade of tool or weapon x_2
balvi	gismu   \n-bav-      \nx_1 is later than or in the future of x_2
bambu	experimental gismu      \nx_1 is a bamboo of variety x_2
bancu	gismu   \n-bac-      \nx_1 is beyond boundary x_2 from x_3 in property or amount x_4
bandu	gismu   \n-bad-      \nx_1 defends x_2 from threat x_3
banfi	gismu      \nx_1 is an amphibian of species x_2
bangu	gismu   \n-ban-   \n-bau-      \nx_1 is a language used by x_2 to communicate x_3
banli	gismu   \n-bal-   \n-ba'i-      \nx_1 is great in property x_2 by the standard x_3
banro	gismu   \n-ba'o-      \nx_1 grows to size or into form x_2 from x_3
banxa	gismu   \n-bax-      \nx_1 is a bank owned by x_2 for banking functions x_3
bapli	gismu   \n-bap-   \n-bai-      \nx_1 forces event x_2 to occur
barda	gismu   \n-bra-      \nx_1 is big in property or dimension x_2 as compared to x_3
bargu	gismu   \n-bag-      \nx_1 is an arch over or around x_2 of material x_3
barja	gismu      \nx_1 is a bar serving x_2 to customers x_3
barna	gismu   \n-ba'a-      \nx_1 is a mark or spot on x_2 of material x_3
bartu	gismu   \n-bar-      \nx_1 is outside of x_2
basfa	experimental gismu      \nx_1 is an omnibus for carrying x_2 in medium x_3 propelled by x_4
basna	gismu      \nx_1 emphasizes x_2 by action x_3
basti	gismu   \n-bas-      \nx_1 replaces x_2 in circumstance x_3
batci	gismu   \n-bat-      \nx_1 bites or pinches x_2 on or at x_3 with x_4
batke	gismu      \nx_1 is a button or knob on x_2 with purpose x_3 of material x_4
bavmi	gismu      \nx_1 is a quantity of barley of species x_2
baxso	gismu      \nx_1 is Malay-Indonesian in aspect x_2
bebna	gismu   \n-beb-      \nx_1 is foolish in action or property x_2
bekpi	experimental gismu      \nx_1 is the back,dorsum of x_2
bemro	gismu   \n-bem-   \n-be'o-      \nx_1 is North American in aspect x_2
bende	gismu   \n-bed-   \n-be'e-      \nx_1 is a team or crew of persons x_2 led by x_3 for purpose x_4
bengo	gismu   \n-beg-      \nx_1 is Bengladesh in aspect x_2
benji	gismu   \n-bej-   \n-be'i-      \nx_1 transmits x_2 to receiver x_3 from origin x_4 via x_5
bersa	gismu   \n-bes-   \n-be'a-      \nx_1 is a son of x_2
berti	gismu   \n-ber-      \nx_1 is to the northern side of x_2 in reference frame x_3
besna	gismu   \n-ben-      \nx_1 is a brain of x_2
betfu	gismu   \n-bef-   \n-be'u-      \nx_1 is a abdomen or lower trunk of x_2
betri	gismu   \n-bet-      \nx_1 is a tragedy for x_2
bevri	gismu   \n-bev-   \n-bei-      \nx_1 transports or carries x_2 to x_3 from x_4 by path x_5
bidju	gismu      \nx_1 is a bead or pebble made of x_2
bifce	gismu   \n-bic-      \nx_1 is a bee or wasp of species x_2
bikla	gismu   \n-bik-      \nx_1 whips or lashes
bilga	gismu   \n-big-      \nx_1 is obligated to do x_2 by agreement x_3
bilma	gismu   \n-bi'a-      \nx_1 is ill or sick with symptoms x_2 from disease x_3
bilni	gismu   \n-bil-      \nx_1 is regimented organized by x_2 for purpose x_3
bindo	gismu   \n-bid-      \nx_1 is Indonesian in aspect x_2
binra	gismu      \nx_1 insures x_2 against threat x_3 with benefit x_4
binxo	gismu   \n-bix-   \n-bi'o-      \nx_1 transforms into x_2
birje	gismu      \nx_1 is made of or contains beer or ale brewed from x_2
birka	gismu   \n-bir-      \nx_1 is an arm of x_2
birti	gismu   \n-bit-      \nx_1 is convinced that x_2 is true
bisli	gismu   \n-bis-      \nx_1 is a quantity of ice made of x_2
bitmu	gismu   \n-bim-   \n-bi'u-      \nx_1 is a wall or fence separating x_2 and x_3 of or in structure x_4
bitni	experimental gismu      \nx_1(entity) is x_2(number) bits in size
blabi	gismu   \n-lab-      \nx_1 is white
blaci	gismu      \nx_1 is a quantity of glass of material x_2
blanu	gismu   \n-bla-      \nx_1 is blue
bliku	gismu   \n-bli-      \nx_1 is a block of material x_2 with surfaces or sides x_3
bloti	gismu   \n-lot-   \n-blo-   \n-lo'i-      \nx_1 is a boat or ship for carrying x_2 propelled by x_3
bluji	experimental gismu      \nx_1 is a pair of jeans / blue jeans
bolci	gismu   \n-bol-   \n-boi-      \nx_1 is a ball or sphere made of x_2
bongu	gismu   \n-bog-   \n-bo'u-      \nx_1 is a bone performing function x_2 in the body of x_3
botpi	gismu   \n-bot-   \n-bo'i-      \nx_1 is a bottle, jar, or flask for x_2 made of x_3 with lid x_4
boxfo	gismu   \n-bof-   \n-bo'o-      \nx_1 is a sheet or blanket made of x_3
boxna	gismu   \n-bon-   \n-bo'a-      \nx_1 is a wave in x_2 with wave-form x_3, wavelength x_4, and frequency x_5
bradi	gismu      \nx_1 is an enemy of x_2 in struggle x_3
bratu	gismu      \nx_1 is hail or sleet of material x_2
brazo	gismu   \n-raz-      \nx_1 is Brazilian in aspect x_2
bredi	gismu   \n-red-   \n-bre-      \nx_1 is ready for x_2
bridi	gismu   \n-bri-      \nx_1 is a predicate with relationship x_2 among arguments x_3
brife	gismu   \n-bif-   \n-bi'e-      \nx_1 is wind from direction x_2 with speed x_3
briju	gismu   \n-bij-      \nx_1 is an office or bureau of worker x_2 at location x_3
brito	gismu   \n-rit-      \nx_1 is British in aspect x_2
broda	gismu   \n-rod-      \nx_1 is the predicate variable 1
brode	gismu   \n-bo'e-      \nx_1 is the predicate variable 2
brodi	gismu      \nx_1 is the predicate variable 3
brodo	gismu      \nx_1 is the predicate variable 4
brodu	gismu      \nx_1 is the predicate variable 5
bruna	gismu   \n-bun-   \n-bu'a-      \nx_1 is a brother of x_2 by bond x_3
budjo	gismu   \n-buj-   \n-bu'o-      \nx_1 is Buddhist in aspect x_2
bukpu	gismu   \n-buk-   \n-bu'u-      \nx_1 is a quantity of cloth made of x_2
bumru	gismu   \n-bum-      \nx_1 is covered by a fog or mist of liquid x_2
bunda	gismu   \n-bud-      \nx_1 is x_2 non-metric weight units in standard x_3 with subunits x_4
bunre	gismu   \n-bur-   \n-bu'e-      \nx_1 is brown
burcu	gismu   \n-bru-      \nx_1 is a brush for x_2 with bristles x_3
burna	gismu      \nx_1 is embarrassed about x_2
cabna	gismu   \n-cab-      \nx_1 is current with x_2 in time
cabra	gismu   \n-ca'a-      \nx_1 is apparatus for function x_2 controlled by x_3
cacra	gismu      \nx_1 is x_2 hours in duration
cadzu	gismu   \n-dzu-      \nx_1 walks on surface x_2 using limbs x_3
cafne	gismu   \n-caf-      \nx_1 (nu) occurs frequently
cagna	experimental gismu      \nx_1 is a wound on body x_2 at locus x_3 caused by x_4
cakla	gismu      \nx_1 is made of or contains a quantity of chocolate or cocoa
calku	gismu   \n-cak-      \nx_1 is a shell or husk around x_2 made of x_3
canci	gismu      \nx_1 vanishes from location x_2 using senses or sensor x_3
cando	gismu   \n-cad-      \nx_1 is idle or at rest
cange	gismu   \n-cag-      \nx_1 is a farm or ranch at x_2 farmed by x_3 that raises or produces x_4
canja	gismu   \n-caj-      \nx_1 trades x_2 for x_3 with x_4
canko	gismu   \n-ca'o-      \nx_1 is a window or portal in wall or building x_2
canlu	gismu   \n-cal-   \n-ca'u-      \nx_1 is a space or room occupied by x_2
canpa	gismu   \n-cna-      \nx_1 is a shovel or spade for digging x_2
canre	gismu   \n-can-      \nx_1 is a quantity of sand or grit from x_2 of composition x_3
canti	gismu      \nx_1 is the intestines or guts of x_2
carce	gismu      \nx_1 is a carriage or wagon for carrying x_2 propelled by x_3
carmi	gismu   \n-cam-   \n-cai-      \nx_1 is bright or intense in property x_2 as measured by observer x_3
carna	gismu   \n-car-      \nx_1 turns or rotates around axis x_2 in direction x_3
cartu	gismu   \n-cat-      \nx_1 is a chart or diagram of x_2 showing information x_3
carvi	gismu   \n-cav-      \nx_1 rains or showers to x_2 from x_3
casnu	gismu   \n-snu-      \nx_1 discusses or talks about x_2
catke	gismu   \n-ca'e-      \nx_1 shoves or pushes x_2 at location x_3
catlu	gismu   \n-cta-      \nx_1 looks at x_2
catni	gismu   \n-ca'i-      \nx_1 has authority over x_2 on the basis of x_3
catra	gismu      \nx_1 kills x_2 by action x_3
caxno	gismu   \n-cax-      \nx_1 is shallow in direction x_2 from reference point x_3
cecla	gismu   \n-cel-   \n-ce'a-      \nx_1 launches projectile or missile x_2 propelled by x_3
cecmu	gismu   \n-cem-   \n-ce'u-      \nx_1 is a community or colony of organisms x_2
cedra	gismu      \nx_1 is an era or age characterized by x_2
cenba	gismu   \n-cne-      \nx_1 varies in property or quantity x_2 in amount x_3
censa	gismu   \n-ces-      \nx_1 is holy or sacred to x_2
centi	gismu   \n-cen-      \nx_1 is a hundreth of x_2 in dimension or aspect x_2
cerda	gismu   \n-ced-      \nx_1 is an inheritor of or heir to x_2 from x_3 according to rule x_4
cerni	gismu   \n-cer-      \nx_1 is a morning of day x_2 at location x_3
certu	gismu   \n-cre-      \nx_1 is an expert or is skilled at x_2
cevni	gismu   \n-cev-   \n-cei-      \nx_1 is a god of people or religion x_2 with dominion over x_3
cfari	gismu   \n-cfa-      \nx_1 commences, begins, or starts
cfika	gismu   \n-fik-   \n-fi'a-      \nx_1 is a work of fiction about plot or theme x_2 by author x_3
cfila	gismu   \n-cfi-      \nx_1 is a flaw or defect in x_2 causing x_3
cfine	gismu      \nx_1 is a wedge of material x_2
cfipu	gismu   \n-fi'u-      \nx_1 confuses or baffles x_2 due to property x_3
ciblu	gismu   \n-blu-      \nx_1 is blood or vital fluid of organism x_2
cicna	gismu      \nx_1 is cyan or torquoise
cidja	gismu   \n-dja-      \nx_1 is food or nutriment for x_2
cidni	gismu   \n-cid-      \nx_1 is the knee, elbow, or other hinged joint of limb x_2 of body x_3
cidro	gismu   \n-dro-      \nx_1 is a quantity of hydrogen
cifnu	gismu   \n-cif-      \nx_1 is an infant or baby of species x_2
cigla	gismu   \n-cig-      \nx_1 is a gland secreting x_2 of body x_3
cikna	gismu   \n-cik-      \nx_1 is awake
cikre	gismu      \nx_1 repairs or mends x_2 for use x_3
ciksi	gismu   \n-cki-      \nx_1 explains x_2 to x_3 with explanation x_4
cilce	gismu   \n-cic-      \nx_1 is wild or untamed
cilmo	gismu   \n-cim-      \nx_1 is moist or damp with liquid x_2
cilre	gismu   \n-cli-      \nx_1 learns x_2 about x_3 from x_4 by method x_5
cilta	gismu   \n-cil-      \nx_1 is a thread of material x_2
cimde	gismu      \nx_1 is a dimension of space or object x_2 according to rule or model x_3
cimni	gismu      \nx_1 in infinite in property or dimension x_2 to degree or of type x_3
cinba	gismu      \nx_1 kisses x_2 at x_3
cindu	gismu      \nx_1 is an oak of species x_2
cinfo	gismu      \nx_1 is a lion of species x_2
cinje	gismu   \n-cij-      \nx_1 is a wrinkle in x_2
cinki	gismu      \nx_1 is an insect of species x_2
cinla	gismu      \nx_1 is thin in dimension x_2
cinmo	gismu   \n-cni-      \nx_1 feels emotion x_2 about x_3
cinri	gismu   \n-ci'i-      \nx_1 interests x_2
cinse	gismu   \n-cin-      \nx_1 in activity or state x_2 exhibits sexuality x_3
cinta	gismu      \nx_1 is paint of substance x_2 in a base of x_3
cinza	gismu      \nx_1 is a pincer or tongs for x_2 to pinch x_3
cipni	gismu   \n-cpi-      \nx_1 is a bird of species x_2
cipra	gismu   \n-cip-      \nx_1 is a test of x_2 in subject x_3
cirko	gismu   \n-cri-      \nx_1 loses x_2 at x_3
cirla	gismu      \nx_1 is a quantity of cheese from source x_2
ciska	gismu   \n-ci'a-      \nx_1 writes x_2 on x_3 using x_4
cisma	gismu      \nx_1 smiles
ciste	gismu   \n-ci'e-      \nx_1 is a system with structure x_2, components x_3, displaying property x_4
citka	gismu   \n-cti-      \nx_1 eats x_2
citno	gismu   \n-cit-   \n-ci'o-      \nx_1 is young in that it has x_2 (ka)
citri	gismu   \n-cir-      \nx_1 is a history of x_2 according to x_3
citsi	gismu      \nx_1 is a season defined by x_2 of year(s) x_3
civla	gismu   \n-civ-      \nx_1 is a flea or louse of species x_2 parasitic on x_3
cizra	gismu   \n-ciz-      \nx_1 is strange to x_2 in property x_3
ckabu	gismu      \nx_1 is a quantity of rubber from source x_2 made of x_3
ckafi	gismu   \n-kaf-      \nx_1 is a quantity of coffee from source x_2
ckaji	gismu   \n-kai-      \nx_1 is characterized by property x_2
ckana	gismu   \n-cka-      \nx_1 is a bed of material x_2 for holding or supporting x_3
ckape	gismu   \n-cap-      \nx_1 is dangerous for x_2
ckasu	gismu   \n-cas-      \nx_1 ridicules x_2 about x_3 by doing x_4
ckeji	gismu   \n-kej-   \n-cke-      \nx_1 feels ashamed under conditions x_2 before audience x_3
ckiku	gismu   \n-kik-      \nx_1 is a key fitting lock x_2 with properties x_3
ckilu	gismu   \n-ci'u-      \nx_1 is a scale of units for measuring x_2
ckini	gismu   \n-ki'i-      \nx_1 is related to x_2 by relationship x_3
ckire	gismu   \n-kir-      \nx_1 is grateful or thankful to x_2 for x_3
ckule	gismu   \n-kul-   \n-cu'e-      \nx_1 is a school at x_2, teaching x_3 to x_4, operated by x_5
ckunu	gismu   \n-ku'u-      \nx_1 is a conifer of species x_2 with cones x_3
cladu	gismu   \n-lau-      \nx_1 is loud at observation point x_2
clani	gismu   \n-cla-      \nx_1 is long in dimension x_2
claxu	gismu   \n-cau-      \nx_1 lacks x_2
clika	gismu      \nx_1 is lichen or moss of species x_2 growing on x_3
clira	gismu   \n-lir-      \nx_1 (nu) is early by standard x_2
clite	gismu   \n-lit-      \nx_1 is polite in matter x_2 according to custom x_3
cliva	gismu   \n-liv-   \n-li'a-      \nx_1 leaves x_2 via x_3
clupa	gismu   \n-cup-      \nx_1 is a loop of material x_2
cmaci	gismu      \nx_1 is mathematics of type x_2
cmalu	gismu   \n-cma-      \nx_1 is small in dimension x_2
cmana	gismu   \n-ma'a-      \nx_1 is a mountain projecting from x_2
cmavo	gismu   \n-ma'o-      \nx_1 is a structure word of group x_2, meaning x_3, used in language x_4
cmene	gismu   \n-cme-   \n-me'e-      \nx_1 is the name for x_2 used by x_3
cmila	gismu   \n-mi'a-      \nx_1 laughs
cmima	gismu   \n-mim-   \n-cmi-      \nx_1 is a member of x_2
cmoni	gismu   \n-cmo-   \n-co'i-      \nx_1 moans or howls x_2 expressing x_3
cnano	gismu   \n-na'o-      \nx_1 is an average in property or amount x_2 among set x_3
cnebo	gismu   \n-neb-   \n-ne'o-      \nx_1 is the neck of x_2
cnemu	gismu   \n-nem-   \n-ne'u-      \nx_1 rewards x_2 for atypical event or property x_3 with x_4
cnici	gismu   \n-nic-      \nx_1 is neat or orderly in property x_2
cnino	gismu   \n-nin-   \n-ni'o-      \nx_1 is new to x_2 in property x_3
cnisa	gismu   \n-nis-      \nx_1 is a quantity of lead
cnita	gismu   \n-nit-   \n-ni'a-      \nx_1 is directly beneath or below x_2 in reference frame x_3
cokcu	gismu   \n-cko-      \nx_1 soaks up x_2 from x_3 into x_4
condi	gismu   \n-con-   \n-cno-   \n-coi-      \nx_1 is deep in property x_2 away from x_3
corci	experimental gismu      \nx_1 is body language expressing x_2 (abstraction) using body parts x_3 in motion x_4\nProposed morpheme: -coc-
cortu	gismu   \n-cor-   \n-cro-      \nx_1 feels pain at x_2
cpacu	gismu   \n-cpa-      \nx_1 acquires or gets x_2 from x_3
cpana	gismu      \nx_1 on top of x_2 in frame of reference x_3
cpare	gismu   \n-par-      \nx_1 climbs on x_2 in direction x_3 using x_4
cpedu	gismu   \n-cpe-      \nx_1 requests or asks for x_2 from x_3 in manner x_4
cpina	gismu      \nx_1 is pungent or irritating to sense x_2
cradi	gismu      \nx_1 broadcasts or transmits x_2 via station or frequency x_3 to receiver x_4
crane	gismu   \n-cra-      \nx_1 is in front of x_2 facing x_3
creka	gismu   \n-cek-      \nx_1 is a shirt of material x_2
crepu	gismu   \n-rep-      \nx_1 harvests x_2 from x_3
cribe	gismu   \n-rib-      \nx_1 is a bear of species x_2
crida	gismu   \n-rid-      \nx_1 is a fairy, elf, or other mythical humanoid of religion x_2
crino	gismu   \n-ri'o-      \nx_1 is green
cripu	gismu   \n-rip-      \nx_1 is a bridge across x_2 between x_3 and x_4
crisa	gismu   \n-cis-      \nx_1 is summer of year x_2 at location x_3
critu	gismu      \nx_1 is autumn of year x_2 at location x_3
ctaru	gismu      \nx_1 as a tide in x_2 caused by x_3
ctebi	gismu   \n-teb-      \nx_1 is the lip of orifice x_2 of body x_3
cteki	gismu   \n-tek-   \n-ce'i-      \nx_1 is a tax on x_2 levied against x_3 by authority or collector x_4
ctile	gismu      \nx_1 is a quantity of petroleum from source x_2
ctino	gismu   \n-ti'o-      \nx_1 as a shadow of x_2 made by light source x_3
ctuca	gismu   \n-ctu-      \nx_1 teaches to x_2 ideas x_3 about subject x_4 by method x_5
cukla	gismu   \n-cuk-      \nx_1 is round
cukta	gismu   \n-cku-      \nx_1 is a book with work x_2 by author x_3 for audience x_4 in medium x_5
culno	gismu   \n-clu-      \nx_1 is full of x_2
cumki	gismu   \n-cum-   \n-cu'i-      \nx_1 is possible\nSee {fau}
cumla	gismu   \n-cul-      \nx_1 is modest or humble about x_2
cunmi	gismu      \nx_1 is a quantity of millet or grain of species x_2
cunso	gismu   \n-cun-   \n-cu'o-      \nx_1 is random under conditions x_2 with probability distribution x_3
cuntu	gismu   \n-cu'u-      \nx_1 is an affair or organized activity involving people x_2
cupra	gismu   \n-pra-      \nx_1 produces x_2 by process x_3
curmi	gismu   \n-cru-      \nx_1 lets x_2 happen
curnu	gismu   \n-cur-      \nx_1 is a worm of species x_2
curve	gismu   \n-cuv-      \nx_1 is pure in property x_2
cusku	gismu   \n-cus-   \n-sku-      \nx_1 says x_2 for audience x_3 via medium x_4
cutci	gismu   \n-cuc-      \nx_1 is a shoe for covering x_2 of material x_3
cutne	gismu   \n-cut-      \nx_1 is the chest of x_2
cuxna	gismu   \n-cux-   \n-cu'a-      \nx_1 chooses x_2 from set x_3
dacru	gismu   \n-dac-      \nx_1 is a drawer in x_2 for contents x_3
dacti	gismu   \n-dai-      \nx_1 is a material object enduring in space-time; x_1 is a thing
dadjo	gismu   \n-daj-      \nx_1 is Taoist in aspect x_2
dakfu	gismu   \n-dak-      \nx_1 is a knife for cutting x_2 with blade material x_3
dakli	gismu      \nx_1 is a bag or sack containing x_2 of material x_3
damba	gismu   \n-dab-   \n-da'a-      \nx_1 fights or struggles with x_2 over issue x_3
damri	gismu      \nx_1 is a drum, gong or other percussion instrument with beater x_2
dandu	gismu   \n-dad-      \nx_1 is suspended or hangs from x_2 at joint x_3
danfu	gismu   \n-daf-      \nx_1 is the answer or solution to question or problem x_2
danlu	gismu   \n-dal-   \n-da'u-      \nx_1 is a creature of species x_2
danmo	gismu   \n-dam-      \nx_1 is smoke from source x_2
danre	gismu   \n-da'e-      \nx_1 puts pressure on or applies force to x_2
dansu	gismu      \nx_1 dances to accompaniment or rhythm x_2
danti	gismu   \n-dan-      \nx_1 is a bullet, missile, or other ballistic projectile for firing by x_2
daplu	gismu   \n-plu-      \nx_1 is an island of material or property x_2 surrounded by x_3
dapma	gismu   \n-dap-      \nx_1 condemns or curses x_2 to fate x_3
dargu	gismu   \n-dag-      \nx_1 is a road or highway to x_2 from x_3 via x_4
darlu	gismu   \n-dau-      \nx_1 argues for stance x_2 against stance x_3
darno	gismu   \n-dar-   \n-da'o-      \nx_1 is distant from x_2 in property x_3
darsi	gismu      \nx_1 shows audacity in behavior x_2
darxi	gismu   \n-dax-   \n-da'i-      \nx_1 hits or strikes x_2 with x_3 at x_4
daski	gismu      \nx_1 is a pocket or pouch in x_2
dasni	gismu   \n-das-      \nx_1 wears x_2 as garment of type x_3
daspo	gismu   \n-spo-      \nx_1 destroys x_2
dasri	gismu   \n-sri-      \nx_1 is a ribbon or strip of material x_2
datka	gismu      \nx_1 is a duck of species x_2
datni	gismu      \nx_1 is information about x_2 gathered by method x_3
decti	gismu   \n-dec-      \nx_1 is a tenth of x_2 in dimension or aspect x_3
degji	gismu   \n-deg-      \nx_1 is a finger, toe, or digit on limb x_2 of body x_3
dejni	gismu   \n-dej-      \nx_1 owes debt x_2 to creditor x_3 in return for x_4
dekpu	gismu      \nx_1 is x_2 non-metric volume units in standard x_3 with subunits x_4
dekto	gismu   \n-dek-      \nx_1 is ten of x_2 in dimension or aspect x_3
delno	gismu   \n-del-   \n-de'o-      \nx_1 is x_2 candela in luminosity
dembi	gismu   \n-deb-      \nx_1 is a legume, bean, or pea from plant x_2
denci	gismu   \n-den-   \n-de'i-      \nx_1 is a tooth of x_2
denmi	gismu   \n-dem-      \nx_1 is dense in property x_2 at location x_3
denpa	gismu   \n-dep-   \n-de'a-      \nx_1 waits or pauses for x_2 at state x_3 before doing x_4
dertu	gismu   \n-der-   \n-de'u-      \nx_1 is a quantity of soil or dirt from x_2 of composition x_3
derxi	gismu   \n-dre-      \nx_1 is a heap or stack of materials x_2 at location x_3
desku	gismu   \n-des-      \nx_1 is shakes or vibrates from force x_2
detri	gismu   \n-det-      \nx_1 is the date of event x_2 at location x_3 by calendar x_4
dicra	gismu   \n-dir-      \nx_1 interrupts or disrupts x_2 due to quality x_3
didni	experimental gismu      \nx_1 deduces/reasons by deduction/establishes by deduction that x_2 is true about x_3 from general rule x_4
dikca	gismu   \n-dic-      \nx_1 is electricity in x_2 of polarity or quantity x_3
diklo	gismu   \n-klo-      \nx_1 is confined to location x_2 within range x_3
dikni	gismu   \n-dik-      \nx_1 is regular or periodic in x_2 with interval x_3
dilcu	gismu      \nx_1 is a quotient of, x_2 divided by x_3, leaving remainder x_4
dilnu	gismu   \n-dil-      \nx_1 is a cloud of material x_2 in air mass x_3 at elevation x_4
dimna	gismu   \n-dim-      \nx_1 is a fate or destiny of x_2
dinju	gismu   \n-dij-   \n-di'u-      \nx_1 is a building for purpose x_2
dinko	gismu   \n-di'o-      \nx_1 is a nail or tack of type x_2 of material x_3
dirba	gismu   \n-dib-      \nx_1 is dear or precious to x_2
dirce	gismu   \n-di'e-      \nx_1 radiates or emits x_2
dirgo	gismu   \n-dig-      \nx_1 is a drop of x_2 in surrounding material x_3
ditcu	experimental gismu      \nx_1 is the time-duration/period of event x_2.
dizlo	gismu   \n-diz-   \n-dzi-      \nx_1 is low or down in reference frame x_2 compared to height x_3
djacu	gismu   \n-jac-   \n-jau-      \nx_1 is a quantity of water
djedi	gismu   \n-dje-   \n-dei-      \nx_1 is x_2 full days long
djica	gismu   \n-dji-      \nx_1 desires or wants x_2 for purpose x_3
djine	gismu   \n-jin-      \nx_1 is a ring of material x_2 with inside, outside diameters x_3, x_4
djuno	gismu   \n-jun-   \n-ju'o-      \nx_1 knows fact x_2 about x_3 by epistemology x_4
donri	gismu   \n-dor-   \n-do'i-      \nx_1 is daytime of day x_2 at location x_3
dotco	gismu   \n-dot-   \n-do'o-      \nx_1 is German in aspect x_2
draci	gismu      \nx_1 is a drama or play about x_2 by x_3 for audience x_4 with actors x_4
drani	gismu   \n-dra-      \nx_1 is correct in property or aspect x_2 for situation x_3
drata	gismu   \n-dat-      \nx_1 is not the same as x_2
drudi	gismu   \n-rud-   \n-dru-      \nx_1 is a roof or lid of x_2
dugri	gismu   \n-dug-      \nx_1 is the logarithm of x_2 with base x_3
dukse	gismu   \n-dus-   \n-du'e-      \nx_1 is too much in x_2 (ka) for purpose x_3 (nu) to take place\nExcess. See {banzu}
dukti	gismu   \n-dut-      \nx_1 is opposite or contrary to x_2 in property or on scale x_3
dunda	gismu   \n-dud-   \n-du'a-      \nx_1 gives or donates x_2 to x_3
dunja	gismu   \n-duj-      \nx_1 freezes at temperature x_2 and pressure x_3
dunku	gismu   \n-duk-   \n-du'u-      \nx_1 is distressed or anguished by x_2
dunli	gismu   \n-dun-   \n-du'i-      \nx_1 is equal to x_2 in property, dimension, or quantity x_3
dunra	gismu   \n-dur-      \nx_1 is winter of year x_2 at location x_3
dzena	gismu   \n-dze-      \nx_1 is an elder or ancestor of x_2 by bond x_3
dzipo	gismu   \n-zip-   \n-zi'o-      \nx_1 is Antarctican in aspect x_2
facki	gismu   \n-fak-   \n-fa'i-      \nx_1 discovers x_2 about x_3
fadni	gismu   \n-fad-      \nx_1 is ordinary in property x_2 among members of x_3
fagri	gismu   \n-fag-      \nx_1 is a fire in fuel x_2 burning in x_3
falnu	gismu   \n-fan-      \nx_1 is a sail for gathering x_2 on vehicle x_3
famti	gismu      \nx_1 is an aunt or uncle of x_2 by bond x_3
fancu	gismu      \nx_1 is a function mapping domain x_2 to range x_3 defined by rule x_4
fange	gismu      \nx_1 is foreign or unfamiliar to x_2 in property x_3
fanmo	gismu   \n-fam-   \n-fa'o-      \nx_1 is an end or finish of or process x_2
fanri	gismu      \nx_1 is a factory or mill producing x_2 from x_3
fanta	gismu      \nx_1 prevents x_2 from occurring
fanva	gismu      \nx_1 translates x_2 to language x_3 from language x_4 with result x_5
fanza	gismu   \n-faz-      \nx_1 annoys x_2
fapro	gismu   \n-fap-   \n-pro-      \nx_1 opposes x_2 about x_3
farlu	gismu   \n-fal-   \n-fa'u-      \nx_1 falls to x_2 from x_3 in gravity well x_4
farna	gismu   \n-far-   \n-fa'a-      \nx_1 is the direction of x_2 from origin x_3
farvi	gismu   \n-fav-      \nx_1 evolves or develops into x_2 from x_3 through stages x_4
fasnu	gismu   \n-fau-      \nx_1 occurs or happens
fatci	gismu   \n-fac-      \nx_1 is a fact
fatne	gismu   \n-fat-   \n-fa'e-      \nx_1 is in reverse order from x_2
fatri	gismu   \n-fai-      \nx_1 is distributed among x_2 with shares x_3
febvi	gismu   \n-feb-      \nx_1 boils at temperature x_2 and pressure x_3
femti	gismu   \n-fem-      \nx_1 is 10 to the negative fifteenth of x_2 in dimension x_3
fendi	gismu   \n-fed-      \nx_1 divides x_2 into x_3 by method x_4
fengu	gismu   \n-feg-   \n-fe'u-      \nx_1 is angry at x_2 for x_3
fenki	gismu   \n-fek-      \nx_1 (person, nu) is crazy
fenra	gismu   \n-fer-   \n-fe'a-      \nx_1 is a crack in x_2
fenso	gismu   \n-fen-   \n-fe'o-      \nx_1 sews or stitches x_2 together with tool x_3 using filament x_4
fepni	gismu   \n-fep-   \n-fei-      \nx_1 is measured in money subunits as quantity x_2 in monetary system x_3
fepri	gismu      \nx_1 is the lung of x_2
ferti	gismu   \n-fre-      \nx_1 is fertile for growing x_2
festi	gismu   \n-fes-      \nx_1 is waste from x_2
fetsi	gismu   \n-fet-   \n-fe'i-      \nx_1 is a female of species x_2 with feminine traits x_3
figre	gismu   \n-fig-      \nx_1 is a fig of species x_2
filso	gismu   \n-fis-      \nx_1 is Palestinian in aspect x_2
finpe	gismu   \n-fip-   \n-fi'e-      \nx_1 is a fish of species x_2
finti	gismu   \n-fin-   \n-fi'i-      \nx_1 invents or creates x_2 for purpose x_3 from existing ideas x_4
firca	experimental gismu      \nx_1 flirts with x_2 by doing x_3
flalu	gismu   \n-fla-      \nx_1 is a law specifying x_2 for community x_3 under conditions x_4 by lawgiver x_5
flani	gismu      \nx_1 is a flute, fife, or recorder
flecu	gismu   \n-fle-      \nx_1 is a current in x_2 flowing towards x_3 from x_4
fliba	gismu   \n-fli-      \nx_1 fails at doing x_2
flira	gismu   \n-fir-      \nx_1 is the face of x_2
foldi	gismu   \n-flo-   \n-foi-      \nx_1 is a field of material x_2
fonmo	gismu   \n-fom-   \n-fo'o-      \nx_1 is a quantity of  foam or froth of material x_2 with bubbles of x_3
fonxa	gismu   \n-fon-      \nx_1 is a phone or modem in network x_2
forca	gismu   \n-fro-      \nx_1 is a fork for x_2 with tines x_3 on base x_4
fraso	gismu   \n-fas-      \nx_1 is French in aspect x_2
frati	gismu   \n-fra-      \nx_1 responds or reacts with action x_2 to x_3
fraxu	gismu   \n-fax-      \nx_1 forgives x_2 for x_3
frica	gismu   \n-fic-      \nx_1 differs from x_2 in x_3
friko	gismu   \n-fi'o-      \nx_1 is African in aspect x_2
frili	gismu   \n-fil-      \nx_1 is easy for x_2
frinu	gismu      \nx_1 is a fraction of x_2 divided by x_3
friti	gismu   \n-fit-      \nx_1 offers x_2 to x_3 with conditions x_4
frumu	gismu   \n-fru-      \nx_1 frowns
fukpi	gismu   \n-fuk-   \n-fu'i-      \nx_1 is a copy of x_2 in form x_3 made by method x_4
fulta	gismu   \n-ful-   \n-flu-      \nx_1 floats in or on x_2
funca	gismu   \n-fun-   \n-fu'a-      \nx_1 is determined by the fortune of x_2
fusra	gismu   \n-fur-      \nx_1 rots or decays with agent x_2
fuzme	gismu   \n-fuz-   \n-fu'e-      \nx_1 is responsible for x_2 to authority x_3
gacri	gismu   \n-gai-      \nx_1 is a lid for covering x_2
gadri	gismu   \n-gad-      \nx_1 is an article labelling x_2 in language x_3 with semantics x_4
galfi	gismu   \n-gaf-   \n-ga'i-      \nx_1 modifies or changes x_2 into x_3
galtu	gismu   \n-gal-   \n-ga'u-      \nx_1 is high in reference frame x_2 compared with x_3
galxe	gismu      \nx_1 is a throat of x_2
ganlo	gismu   \n-ga'o-      \nx_1 is closed, preventing access to x_2 by x_3
ganra	gismu   \n-gan-      \nx_1 is broad or wide in dimension x_2
ganse	gismu   \n-gas-   \n-ga'e-      \nx_1 detects or senses x_2 by means x_3
ganti	gismu      \nx_1 is a gonad, ovary, or equivalent of x_2 of gender x_3
ganxo	gismu   \n-gax-      \nx_1 is the anus of x_2
ganzu	gismu   \n-gaz-      \nx_1 organizes x_2 into x_3 by system x_4
gapci	gismu   \n-gac-      \nx_1 is a gas of x_2
gapru	gismu   \n-gap-      \nx_1 is directly above x_2 in reference frame x_3
garna	gismu   \n-gar-      \nx_1 is a rail or bar supporting or restraining x_2 of material x_3
gasnu	gismu   \n-gau-      \nx_1 causes x_2 to happen
gaspo	experimental gismu      \nx_1 pertains to gua\\spi language/culture in aspect x_2
gasta	gismu   \n-gat-      \nx_1 is a quantity of steel of composition x_2
genja	gismu   \n-gej-      \nx_1 is a root of x_2
gento	gismu   \n-get-   \n-ge'o-      \nx_1 is Argentinian in aspect x_2
genxu	gismu   \n-gex-      \nx_1 is a hook of material x_2
gerku	gismu   \n-ger-   \n-ge'u-      \nx_1 is a dog of species x_2
gerna	gismu   \n-gen-   \n-ge'a-      \nx_1 is the grammar of language x_2 for text x_3
gidva	gismu   \n-gid-   \n-gi'a-      \nx_1 guides or leads x_2 in x_3
gigdo	gismu   \n-gig-   \n-gi'o-      \nx_1 is a billion or 10 to the ninth of x_2 in dimension or aspect x_3
ginka	gismu   \n-gik-      \nx_1 is a camp of x_2 at x_3
girzu	gismu   \n-gir-   \n-gri-      \nx_1 is a group with common property x_2 due to set x_3 linked by relations x_4
gismu	gismu   \n-gim-   \n-gi'u-      \nx_1 is a root word showing relation x_2 among argument roles x_3 with affix x_4
glare	gismu   \n-gla-      \nx_1 is hot
gleki	gismu   \n-gek-   \n-gei-      \nx_1 is happy about x_2 (nu)
gletu	gismu   \n-let-   \n-gle-      \nx_1 copulates or mates with x_2
glico	gismu   \n-gic-   \n-gli-      \nx_1 is English in aspect x_2
gluta	gismu   \n-glu-      \nx_1 is a glove or mitten of material x_2
gocti	gismu   \n-goc-      \nx_1 is 10 to the negative twenty-fourth of x_2 in dimension or aspect x_3
gotro	gismu   \n-got-      \nx_1 is 10 to the twenty-fourth of x_2 in dimension or aspect x_3
gradu	gismu   \n-rau-      \nx_1 is a unit on scale x_2 measuring property x_3
grake	gismu   \n-gra-      \nx_1 is x_2 grams
grana	gismu   \n-ga'a-      \nx_1 is a rod or pole of material x_2
grasu	gismu   \n-ras-      \nx_1 is a quantity of grease from source x_2
greku	gismu   \n-rek-      \nx_1 is a frame or structure supporting x_2
grusi	gismu   \n-rus-      \nx_1 is gray
grute	gismu   \n-rut-      \nx_1 is a fruit of species x_2
gubni	gismu   \n-gub-      \nx_1 is public to community x_2
gugde	gismu   \n-gug-   \n-gu'e-      \nx_1 is the country of x_2 with territory x_3
gumri	experimental gismu      \nx_1 is a mushroom of species x_2.
gundi	gismu   \n-gud-      \nx_1 is industry producing x_2 by process or means x_3
gunka	gismu   \n-gun-   \n-gu'a-      \nx_1 works on x_2 with goal x_3
gunma	gismu   \n-gum-      \nx_1 is a an aggregate or mass of components x_2
gunro	gismu   \n-gur-   \n-gu'o-      \nx_1 rolls on x_2 rotating on axis or axle x_3
gunse	gismu      \nx_1 is a goose of species x_2
gunta	gismu   \n-gut-      \nx_1 attacks x_2 with goal x_3
gurni	gismu   \n-gru-      \nx_1 is grain from plant x_2
guska	gismu   \n-guk-      \nx_1 abrades x_2 from x_3
gusni	gismu   \n-gus-   \n-gu'i-      \nx_1 lights x_2 from source x_3
gusta	gismu      \nx_1 is a restaurant serving x_2 to x_3
gutci	gismu   \n-guc-      \nx_1 is x_2 non-metric short distance units in standard x_3 with subunits x_4
gutra	gismu      \nx_1 is the womb of x_2
guzme	gismu   \n-guz-   \n-zme-      \nx_1 is a melon of species x_2
infekte	fu'ivla      \nx_1 infects x_2 with illness x_3 (property of x_2)\nSee {bilma}, {vidru}
iste	fu'ivla      \nx_1 is occupied, interested, has a role in x_2 (property)\nOften corresponds to English suffix &quot;-ist&quot;. See {se} {cuntu}, {se} {jibri}
jabre	gismu      \nx_1 brakes or slows x_2 with mechanism x_3
jadni	gismu   \n-jad-   \n-ja'i-      \nx_1 adorns or decorates x_2
jakne	gismu      \nx_1 is a rocket propelled by x_2 carrying x_3
jalge	gismu   \n-jag-   \n-ja'e-      \nx_1 is the result or outcome of x_2
jalna	gismu      \nx_1 is a quantity of starch from x_2 of composition x_3
jalra	gismu      \nx_1 is a cockroach of species x_2
jamfu	gismu   \n-jaf-   \n-jma-      \nx_1 is a foot of x_2
jamna	gismu   \n-jam-      \nx_1 wars against x_2 over x_3
janbe	gismu   \n-jab-      \nx_1 is a bell or chime producing sound x_2
janco	gismu   \n-jan-      \nx_1 is a joint attaching limb x_2 to x_3
janli	gismu   \n-jal-      \nx_1 collides with or crashes into x_2
jansu	gismu   \n-jas-      \nx_1 is a diplomat representing x_2 in negotiation x_3 for purpose x_4
janta	gismu   \n-jat-      \nx_1 is a bill for x_2 billed to x_3 by x_4
jarbu	gismu      \nx_1 is a suburban area of x_2
jarco	gismu   \n-ja'o-      \nx_1 demonstrates or shows x_2 to x_3
jarki	gismu   \n-jak-      \nx_1 is narrow in dimension x_2
jaspu	gismu   \n-jap-      \nx_1 is a passport issued to x_2 by x_3 allowing x_4
jatna	gismu   \n-ja'a-      \nx_1 is a commander or leader of x_2
javni	gismu   \n-jva-      \nx_1 is a rule mandating x_2 within system x_3
jbama	gismu   \n-bam-      \nx_1 is a bomb with explosive x_2
jbari	gismu   \n-jba-      \nx_1 is a berry of plant x_2
jbena	gismu   \n-jbe-      \nx_1 is born to x_2 at time x_3 and place x_4
jbera	gismu   \n-jer-      \nx_1 borrows x_2 from x_3 for interval x_4
jbini	gismu   \n-bin-   \n-bi'i-      \nx_1 is between x_2 in property x_3
jdari	gismu   \n-jar-      \nx_1 is firm or resistant to force x_2 under conditions x_3
jdice	gismu   \n-jdi-      \nx_1 makes decision x_2 about x_3
jdika	gismu      \nx_1 decreases in x_2 by amount x_3
jdima	gismu   \n-di'a-      \nx_1 is the price of x_2 to x_3 set by x_4
jdini	gismu   \n-din-   \n-di'i-      \nx_1 is money issued by x_2
jduli	gismu   \n-dul-   \n-jdu-      \nx_1 is a quantity of jelly of material x_2
jecta	gismu   \n-jec-   \n-je'a-      \nx_1 is a polity or state governing x_2
jeftu	gismu   \n-jef-      \nx_1 is x_2 weeks long
jegvo	gismu   \n-jeg-   \n-je'o-      \nx_1 is Judean, Christian, or Moslem in aspect x_2
jelca	gismu   \n-jel-      \nx_1 burns at temperature x_2 in atmosphere x_3
jemna	gismu   \n-jme-      \nx_1 is a gem of type x_2 and material x_3
jenca	gismu   \n-jen-      \nx_1 shocks or stuns x_2
jendu	gismu   \n-jed-      \nx_1 is an axle on which x_2 rotates, of material x_3
jenmi	gismu   \n-jem-   \n-jei-      \nx_1 is an army serving x_2 in function x_3
jerna	gismu      \nx_1 earns salary or pay x_2 for work x_3
jersi	gismu   \n-je'i-      \nx_1 chases x_2
jerxo	gismu   \n-jex-      \nx_1 is Algerian in aspect x_2
jesni	gismu   \n-jes-      \nx_1 is a needle of material x_2
jetce	gismu   \n-je'e-      \nx_1 is a jet of material x_2 expelled from x_3
jetnu	gismu   \n-jet-   \n-je'u-      \nx_1 is true by standard x_2
jgalu	gismu   \n-ja'u-      \nx_1 is a claw of x_2
jganu	gismu   \n-jga-      \nx_1 is an angle from vertex x_2 subtended by lateral x_3
jgari	gismu   \n-jai-      \nx_1 holds or clutches x_2 using x_3 at location x_4
jgena	gismu   \n-jge-      \nx_1 is a knot in x_2
jgina	gismu   \n-gin-      \nx_1 is a gene of x_2 determining trait x_3
jgira	gismu   \n-jgi-      \nx_1 feels pride in x_2
jgita	gismu   \n-git-      \nx_1 is a stringed musical instrument with plectrum or bow x_2
jibni	gismu   \n-jbi-      \nx_1 is near or close to x_2 in property x_3
jibri	gismu   \n-jib-      \nx_1 is a job of person x_2
jicla	gismu      \nx_1 stirs fluid x_2
jicmu	gismu   \n-cmu-      \nx_1 is a basis of x_2
jijnu	gismu   \n-jij-      \nx_1 intuits x_2 about subject x_3
jikca	gismu   \n-jik-      \nx_1 interacts socially with x_2
jikni	experimental gismu      \nx_1 consists of the economic system of sector components x_2
jikru	gismu      \nx_1 is a quantity of liquor distilled from x_2
jilka	gismu   \n-jil-      \nx_1 is a quantity of alkali of composition x_2
jilra	gismu      \nx_1 is envious or jealous of x_2 about x_3
jimca	gismu   \n-jic-      \nx_1 is a branch of x_2
jimpe	gismu   \n-jmi-      \nx_1 understands x_2 about x_3
jimte	gismu   \n-jit-      \nx_1 is a limit or border of x_2 in property x_3
jinci	gismu      \nx_1 are shears or scissors for cutting x_2
jinga	gismu   \n-jig-   \n-ji'a-      \nx_1 wins prize x_2 from x_3 in competition x_4
jinku	gismu      \nx_1 is a vaccine protecting x_2 against x_3 introduced by method x_4
jinme	gismu   \n-jim-      \nx_1 is a quantity of metal of composition x_2
jinru	gismu   \n-jir-      \nx_1 is immersed or submerged in liquid x_2
jinsa	gismu   \n-jis-      \nx_1 is clean of material x_2
jinto	gismu      \nx_1 is a well or spring of fluid x_2 at location x_3
jinvi	gismu   \n-jiv-   \n-ji'i-      \nx_1 opines or thinks that x_2 is true about x_3 because x_4
jinzi	gismu   \n-jiz-      \nx_1 is an innate or natural property of x_2
jipci	gismu      \nx_1 is a chicken of species x_2
jipno	gismu   \n-jip-   \n-ji'o-      \nx_1 is a tip or point on object x_2 at location x_3
jirna	gismu      \nx_1 is a horn of x_2
jisra	gismu      \nx_1 is a quantity of juice from x_2
jitfa	gismu   \n-jif-      \nx_1 is false by standard or epistemology x_2
jitro	gismu   \n-tro-      \nx_1 has control over x_2 in x_3
jivbu	gismu      \nx_1 weaves x_2 from material x_3
jivna	gismu   \n-jvi-      \nx_1 competes with x_2 in contest x_3 for gain x_4
jmaji	gismu   \n-jaj-      \nx_1 gathers at location x_2 from locations x_3
jmifa	gismu      \nx_1 is a shoal or reef of material x_2 in body of water x_3
jmina	gismu   \n-min-      \nx_1 combines or adds x_2 to x_3 with result x_4
jmive	gismu   \n-miv-   \n-ji'e-      \nx_1 is alive in that it does x_2 (ka)
jordo	gismu   \n-jor-   \n-jo'o-      \nx_1 is Jordanian in aspect x_2
jorne	gismu   \n-jon-   \n-jo'e-      \nx_1 is joined to x_2 at location x_3
jubme	gismu   \n-jub-   \n-jbu-      \nx_1 is a table made of x_2 with support x_3
judri	gismu      \nx_1 is an address of x_2 in system x_3
jufra	gismu   \n-juf-   \n-ju'a-      \nx_1 is a sentence or statement about x_2 in language x_3
jukni	gismu   \n-juk-      \nx_1 is a spider of species x_2
jukpa	gismu   \n-jup-      \nx_1 cooks or prepares food x_2 by recipe x_3
julne	gismu   \n-ju'e-      \nx_1 is a filter passing x_2 and prohibiting x_3 with netting properties x_4
jundi	gismu   \n-jud-   \n-ju'i-      \nx_1 pays attention to x_2
jungo	gismu   \n-jug-      \nx_1 is Chinese in aspect x_2
junla	gismu   \n-jul-      \nx_1 is a timer or  clock measuring time units x_2 to precision x_3 with method x_4
junri	gismu   \n-jur-      \nx_1 is earnest or serious about x_2
junta	gismu      \nx_1 is the weight of x_2 in field x_3
jurme	gismu   \n-jum-      \nx_1 is a bacteria or germ of species x_2
jursa	gismu   \n-jus-      \nx_1 is harsh or severe to x_2
jutsi	gismu   \n-jut-      \nx_1 is a species of genus x_2, family x_3, etc.
juxre	gismu   \n-jux-      \nx_1 (nu) is clumsy
jvinu	gismu   \n-vin-   \n-ji'u-      \nx_1 is a view of x_2 from point of view x_3
kabri	gismu      \nx_1 is a cup or mug containing x_2 made of x_3
kacma	gismu      \nx_1 is a camera recording illumination type x_2 images to medium x_3
kadno	gismu      \nx_1 is Canadian in aspect x_2
kafke	gismu      \nx_1 coughs or burps gas x_2 from orifice x_3
kagni	gismu   \n-kag-      \nx_1 is a company or corporation chartered by authority x_2 for purpose x_3
kajde	gismu   \n-jde-      \nx_1 warns x_2 of danger x_3
kajna	gismu      \nx_1 is a shelf or counter on x_2 for purpose x_3
kakne	gismu   \n-ka'e-      \nx_1 is capable of doing x_2
kakpa	gismu      \nx_1 digs x_2 out of x_3 with x_4
kalci	gismu      \nx_1 is excrement or feces of x_2
kalri	gismu   \n-kar-      \nx_1 is open, giving access to x_2 of x_3
kalsa	gismu   \n-kas-      \nx_1 is chaotic in x_2
kalte	gismu   \n-kat-      \nx_1 hunts prey x_2 for purpose x_3
kamju	gismu      \nx_1 is a column of material x_2
kamni	gismu      \nx_1 is a committee with task x_2 of body x_3
kampu	gismu   \n-kau-      \nx_1 is common among x_2
kanba	gismu      \nx_1 is a goat of species x_2
kancu	gismu   \n-kac-      \nx_1 counts the number in set x_2 to be x_3 by units x_4
kandi	gismu   \n-kad-      \nx_1 is dim or non-intense in property x_2 received by x_3
kanji	gismu   \n-kaj-      \nx_1 calculates x_2 from data x_3 by process x_4
kanla	gismu   \n-kal-      \nx_1 is an eye of x_2
kanpe	experimental gismu      \nx_1 expects event x_2 with likelihood x_3 (value from 0 to 1, default is {li} {so'a} i.e. near 1)
kanro	gismu   \n-ka'o-      \nx_1 is healthy or well by standard x_2
kansa	gismu   \n-kan-      \nx_1 accompanies x_2 in x_3
kantu	gismu   \n-ka'u-      \nx_1 is a quantum particle of property x_2
kanxe	gismu   \n-kax-      \nx_1 is a conjunction stating that x_2 and x_3 are both true
karbi	gismu   \n-kab-      \nx_1 compares x_2 with x_3 in property x_4 determining comparison x_5
karce	gismu      \nx_1 is a car or other vehicle for carrying x_2 propelled by x_3
karda	gismu      \nx_1 is a card of material x_2 and shape x_3
kargu	gismu      \nx_1 is expensive to x_2
karli	gismu      \nx_1 is a collar or band surrounding x_2 of material x_3
karni	gismu      \nx_1 is a journal or magazine with content x_2 published by x_3 for audience x_4
katna	gismu   \n-ka'a-      \nx_1 cuts x_2 into pieces x_3
kavbu	gismu   \n-kav-      \nx_1 captures x_2 with trap x_3
kecti	gismu   \n-kec-   \n-ke'i-      \nx_1 feels sorry for x_2 about x_3
kelci	gismu   \n-kel-   \n-kei-      \nx_1 plays with toy x_2
kelvo	gismu   \n-ke'o-      \nx_1 is x_2 degrees Kelvin
kenra	gismu   \n-ken-      \nx_1 is a cancer in x_2
kensa	gismu   \n-kes-      \nx_1 is outer space near x_2
kerfa	gismu   \n-kre-      \nx_1 is hair of x_2 at x_3
kerlo	gismu   \n-ker-      \nx_1 is an ear of x_2
ketco	gismu   \n-ket-   \n-tco-      \nx_1 is South American in aspect x_2
kevna	gismu   \n-kev-   \n-ke'a-      \nx_1 is a cavity or hole in x_2
kibro	experimental gismu      \nx_1 pertains to the internet in aspect x_2.
kicne	gismu   \n-kic-   \n-ki'e-      \nx_1 cushions x_2 with material x_3
kijno	gismu   \n-kij-      \nx_1 is a quantity of oxygen
kilto	gismu   \n-ki'o-      \nx_1 is a thousand of x_2 in dimension x_3
kinda	experimental gismu      \nx_1 is kinda like x_2 in property x_3
kinli	gismu   \n-kil-      \nx_1 is sharp at location x_2
kisto	gismu   \n-kis-      \nx_1 is Pakistani in aspect x_2
klaji	gismu   \n-laj-      \nx_1 is a street or alley at x_2 accessing x_3
klaku	gismu   \n-kak-      \nx_1 weeps or cries tears x_2 for reason x_3
klama	gismu   \n-kla-      \nx_1 goes to x_2 from x_3 via x_4 using means x_5
klani	gismu   \n-lai-      \nx_1 is a quantity measured by x_2 on scale x_3
klesi	gismu   \n-kle-   \n-lei-      \nx_1 is a subset or class of x_2 defined by property x_3
klina	gismu   \n-kli-      \nx_1 is transparent or clear to x_2
kliru	gismu      \nx_1 is a quantity of halogen of type x_2
kliti	gismu   \n-kit-      \nx_1 is a quantity of clay made of x_2
klupe	gismu   \n-lup-   \n-lu'e-      \nx_1 is a screw for purpose x_2 with threads x_3 and frame x_4
kluza	gismu   \n-luz-      \nx_1 is loose on x_2 at location x_3
kobli	gismu   \n-kob-   \n-ko'i-      \nx_1 is a cabbage or lettuce of species x_3
kojna	gismu   \n-koj-   \n-ko'a-      \nx_1 is a corner in x_2 of material x_3
kokso	experimental gismu      \nx_1 is a coconut of variety/cultivar x_2
kolme	gismu   \n-kol-   \n-ko'e-      \nx_1 is a quantity of coal from source x_2
kombitu	fu'ivla      \nx_1 is a comb with teeth, tines x_2 (set)\nSee {kerfa}
komcu	gismu   \n-kom-      \nx_1 is a comb of material x_2 with tines x_3
konju	gismu   \n-kon-   \n-ko'u-      \nx_1 is a cone of material x_2 with vertex x_3
korbi	gismu   \n-kor-   \n-koi-      \nx_1 is an edge or border between x_2 and x_3
korcu	gismu   \n-kro-      \nx_1 is bent or crooked
korka	gismu   \n-kok-      \nx_1 is a quantity of cork from tree x_2
kosta	gismu   \n-kos-      \nx_1 is a jacket or sweater of material x_2
krali	experimental gismu      \nx_1 (ka) is a legal/moral entitlement of individuals x_2 by standard x_3.
kramu	gismu      \nx_1 is x_2 non-metric area units in standard x_3 with subunits x_4
krasi	gismu   \n-kra-      \nx_1 is an origin or source of x_2
krati	gismu   \n-ka'i-      \nx_1 represents x_2 in function x_3
krefu	gismu   \n-ref-   \n-ke'u-      \nx_1 is a recurrence of x_2 happening for the x_3:th time
krici	gismu   \n-kri-      \nx_1 believes x_2 is true about x_3
krili	gismu      \nx_1 is quantity of crystal of composition x_2 in arrangement x_3
krinu	gismu   \n-rin-   \n-ki'u-      \nx_1 is a justification or reason for x_2
krixa	gismu   \n-kix-   \n-ki'a-      \nx_1 yells or cries out x_2
kruca	gismu   \n-kuc-      \nx_1 intersects x_2 at location x_3
kruji	gismu   \n-ruj-      \nx_1 is a quantity of cream of composition x_2
kruvi	gismu   \n-ruv-   \n-kru-      \nx_1 is a curve or bend in x_2 at location x_3 defined by x_4
kubli	gismu   \n-kub-      \nx_1 is a cube of dimensions x_2 and sides x_3
kucli	gismu      \nx_1 is curious about x_2
kufra	gismu   \n-kuf-      \nx_1 is comfortable with x_2
kukte	gismu   \n-kuk-      \nx_1 is tasty or delicious to x_2
kulnu	gismu   \n-klu-      \nx_1 is culture of x_2
kumfa	gismu   \n-kum-   \n-ku'a-      \nx_1 is a room in x_2 surrounded by x_3
kumte	gismu      \nx_1 is a camel or llama of species x_2
kunra	gismu   \n-kun-      \nx_1 is mineral or ore of x_2 mined from x_3
kunti	gismu   \n-kut-      \nx_1 is empty of x_2
kurfa	gismu   \n-kur-      \nx_1 is a right-angle with vertices x_2 and dimensions x_3
kurji	gismu   \n-kuj-   \n-ku'i-      \nx_1 takes care of x_2
kurki	gismu      \nx_1 is bitter or acrid to x_2
kuspe	gismu   \n-kup-   \n-ku'e-      \nx_1 extends or reaches over x_2
kusru	gismu   \n-kus-      \nx_1 is cruel to x_2
labno	gismu      \nx_1 is a wolf of species x_2
lacni	experimental gismu      \nx_1 is an eyewear/glasses used by x_2 serving purpose x_3
lacpu	gismu   \n-lap-   \n-cpu-      \nx_1 pulls or drags x_2 by handle x_3
lacri	gismu   \n-lac-      \nx_1 relies on or trusts x_2 to do x_3
ladru	gismu   \n-lad-      \nx_1 is a quantity of milk from x_2
lafti	gismu   \n-laf-      \nx_1 lifts x_2 at location x_3 in gravity well x_4
lakne	gismu   \n-la'e-      \nx_1 is probable, likely
lakse	gismu   \n-lak-      \nx_1 is a quantity of wax from x_2
laldo	experimental gismu      \nx_1 is old, aged in that it has x_2 (ka)
lalxu	gismu   \n-la'u-      \nx_1 is a lake or pool at site x_2
lamji	gismu   \n-lam-   \n-la'i-      \nx_1 is adjacent or next to x_2 in property x_3 in direction x_4
lanbi	gismu      \nx_1 is a quantity of protein of type x_2 composed of amino acids x_3
lanci	gismu      \nx_1 is a flag or banner symbolizing x_2 with pattern x_3 on material x_4
lanka	gismu      \nx_1 is a basket containing x_2 made of x_3
lanli	gismu   \n-lal-      \nx_1 analyzes x_2 by method x_3
lanme	gismu   \n-lan-      \nx_1 is a sheep of species x_2 and flock x_3
lante	gismu      \nx_1 is a can for x_2 made of x_3
lanxe	gismu   \n-lax-      \nx_1 is in balance under forces x_2
lanzu	gismu   \n-laz-      \nx_1 is a family including x_2 bonded by standard x_3
larcu	gismu   \n-lar-      \nx_1 is an art of craft or skill x_2
lasna	gismu   \n-la'a-      \nx_1 fastens or binds x_2 to x_3 with x_4
lastu	gismu      \nx_1 is a quantity of brass of composition x_2
latmo	gismu   \n-la'o-      \nx_1 is Latin in aspect x_2
latna	gismu      \nx_1 is a lotus of species x_2 symbolizing x_3 to culture x_4
lazni	gismu      \nx_1 is lazy concerning action x_2
lebna	gismu   \n-leb-   \n-le'a-      \nx_1 takes or seizes x_2 from x_3
lelxe	experimental gismu      \nx_1 is a lily of species/strain x_2
lenjo	gismu   \n-len-   \n-le'o-      \nx_1 is a lens focusing x_2 to focus x_3 by means x_4
lenku	gismu   \n-lek-      \nx_1 is cold
lerci	gismu   \n-lec-      \nx_1 is late by standard x_2
lerfu	gismu   \n-ler-   \n-le'u-      \nx_1 is a symbol in alphabet x_2 representing x_3
lianzi	obsolete fu'ivla      \nx_1 is a length of chain with links or rings x_2
libjo	gismu   \n-lib-      \nx_1 is Libyan in aspect x_2
lidne	gismu   \n-li'e-      \nx_1 precedes x_2 in sequence x_3
lifri	gismu   \n-lif-   \n-fri-      \nx_1 experiences x_2
lijda	gismu   \n-jda-      \nx_1 is a religion of believers x_2 sharing beliefs x_3
limna	gismu   \n-lim-      \nx_1 swims in x_2
lindi	gismu   \n-lid-      \nx_1 is lighting at x_2 from x_3
linji	gismu   \n-lij-   \n-li'i-      \nx_1 is a line defined by points x_2
linsi	gismu   \n-lin-      \nx_1 is a length of chain of material x_2 with link properties x_3
linto	gismu   \n-li'o-      \nx_1 is lightweight
lisri	gismu   \n-lis-      \nx_1 is a story about x_2 told by x_3 to x_4
liste	gismu   \n-ste-      \nx_1 is a list of x_2 in order x_3 in medium x_4
litce	gismu   \n-lic-      \nx_1 is x_2 litres
litki	gismu   \n-lik-      \nx_1 is liquid of material x_2
litru	gismu   \n-li'u-      \nx_1 travels via route x_2 using means x_3
livga	gismu      \nx_1 is a liver of x_2
livla	gismu   \n-lil-      \nx_1 is a fuel for powering x_2
logji	gismu   \n-loj-      \nx_1 is a logic for reasoning about x_2\nOnly for logical implications. In colloquial speech &quot;logical&quot; often means {racli} - 'sane'.
loglo	experimental gismu      \nx_1 pertains to Loglan language/culture in aspect x_2
lojbo	gismu   \n-lob-   \n-jbo-      \nx_1 is Lojbanic in aspect x_2
loldi	gismu   \n-lol-   \n-loi-      \nx_1 is a floor or ground of x_2
lorxu	gismu   \n-lor-   \n-lo'u-      \nx_1 is a fox of species x_2
lubno	gismu   \n-lu'o-      \nx_1 is Lebanese in aspect x_2
lujvo	gismu   \n-luv-   \n-jvo-      \nx_1 is a compound word meaning x_2 with arguments x_3 from phrase x_4
lumci	gismu   \n-lum-   \n-lu'i-      \nx_1 washes x_2 of contaminant x_3 with x_4
lunbe	gismu   \n-lub-      \nx_1 is naked or bare
lunra	gismu   \n-lur-      \nx_1 is a moon or major natural satellite of planet x_2
lunsa	gismu   \n-lus-      \nx_1 condenses on x_2 at temperature x_3 and pressure x_4
mabla	gismu   \n-mal-      \nx_1 is shitty, awful, low-quality in property x_2 by standard x_3\nBloody (British sense), fucking, shit, goddamn. See also {zabna}, {xlali}, {palci}, {dapma}
mabru	gismu   \n-mab-      \nx_1 is mammal of species x_2
macnu	gismu   \n-cnu-      \nx_1 is manual in function x_2
makcu	gismu   \n-ma'u-      \nx_1 is mature in quality x_2
makfa	gismu   \n-maf-      \nx_1 is magic or supernatural to x_2 performed by x_3
maksi	gismu   \n-mak-      \nx_1 is magnetic producing field x_2
malsi	gismu   \n-mas-      \nx_1 is a church or temple of religion x_2 at location x_3
mamta	gismu   \n-mam-      \nx_1 is a mother of x_2
manci	gismu   \n-mac-      \nx_1 feels awe or wonder about x_2
manfo	gismu      \nx_1 is uniform in property x_2
mango	experimental gismu      \nx_1 is a mango fruit of variety x_2.
manku	gismu   \n-man-      \nx_1 is dark
manri	gismu   \n-mar-      \nx_1 is a standard for observing x_2 with rules x_3
mansa	gismu      \nx_1 satisfies x_2 in property x_3
manti	gismu      \nx_1 is an ant of species x_2
mapku	gismu   \n-map-      \nx_1 is a hat, helmet, or other headgear of material x_2
mapni	gismu      \nx_1 is a quantity of cotton
mapti	gismu   \n-mat-      \nx_1 is compatible with or matches x_2 by standard x_3
marbi	gismu   \n-mra-      \nx_1 is a shelter for x_2 against threat x_3
marce	gismu   \n-ma'e-      \nx_1 is a vehicle carrying x_2 in or on x_3 propelled by x_4
marde	gismu   \n-mad-      \nx_1 are the ethices of x_2 about situation x_3
margu	gismu   \n-mag-      \nx_1 is a quantity of mercury
marji	gismu   \n-maj-   \n-mai-      \nx_1 is material of type x_2 in shape x_3
marna	gismu      \nx_1 is a quantity of hemp of species x_2
marxa	gismu   \n-max-      \nx_1 crushes or smashes x_2 into x_3
masno	gismu   \n-sno-      \nx_1 is slow at doing x_2
masti	gismu   \n-ma'i-      \nx_1 is x_2 months long
matci	gismu      \nx_1 is a mat or pad of material x_2
matli	gismu      \nx_1 is a quantity of linen
matne	gismu      \nx_1 is a quantity of butter from x_2
matra	gismu      \nx_1 is an engine driving x_2
mavji	gismu   \n-mav-      \nx_1 is a quantity of oats of species x_2
maxri	gismu   \n-xri-      \nx_1 is a quantity of wheat of species x_2
mebri	gismu   \n-meb-      \nx_1 is a brow or forehead of x_2
megdo	gismu   \n-meg-      \nx_1 is a million of x_2 in dimension or aspect x_3
mekso	gismu   \n-mek-   \n-me'o-      \nx_1 is a mathematical expression under rules x_2
melbi	gismu   \n-mel-   \n-mle-      \nx_1 is beautiful to x_2 in aspect x_3 by standard x_4
meljo	gismu   \n-mej-      \nx_1 is Malaysian in aspect x_2
menli	gismu   \n-men-      \nx_1 is a mind of body x_2
mensi	gismu   \n-mes-   \n-me'i-      \nx_1 is a sister of x_2 by bond x_3
mentu	gismu   \n-met-   \n-me'u-      \nx_1 is x_2 minutes long
merko	gismu   \n-mer-      \nx_1 is U.S.American in aspect x_2
merli	gismu   \n-mre-      \nx_1 measures x_2 as x_3 units on scale x_4 with accuracy x_5
mexno	gismu   \n-mex-      \nx_1 is Mexican in aspect x_2
midju	gismu   \n-mij-      \nx_1 is at the middle of x_2
mifra	gismu   \n-mif-      \nx_1 is an encryption of x_2 made using cipher x_3
mikce	gismu   \n-mic-      \nx_1 cures or treats x_2 for ailment x_3 with x_4
mikri	gismu   \n-mik-      \nx_1 is a millionth of x_2 in dimension x_3
milti	gismu   \n-mil-      \nx_1 is a thousandth of x_2 in dimension x_3
milxe	gismu   \n-mli-      \nx_1 is mild in property x_2
minde	gismu   \n-mid-   \n-mi'e-      \nx_1 commands or orders x_2 to x_3
minji	gismu   \n-mi'i-      \nx_1 is a machine for x_2
minli	gismu      \nx_1 is x_2 non-metric long distance units with subunits x_3 in standard x_4
minra	gismu   \n-mir-      \nx_1 reflects or echoes x_2 to observer x_3 as x_4
mintu	gismu   \n-mit-   \n-mi'u-      \nx_1 is identical to x_2 by standard x_3
mipri	gismu   \n-mip-      \nx_1 keeps x_2 hidden from x_3 by method x_4
mirli	gismu      \nx_1 is a deer of species x_3
misno	gismu   \n-mis-   \n-mi'o-      \nx_1 is famous among x_2
misro	gismu      \nx_1 is Egyptian in aspect x_2
mitre	gismu   \n-tre-      \nx_1 is x_2 meters in direction x_3
mixre	gismu   \n-mix-   \n-xre-      \nx_1 is a mixture including x_2
mlana	gismu   \n-mla-      \nx_1 is aside x_2, facing x_3, in reference frame x_4
mlatu	gismu   \n-lat-      \nx_1 is a cat of species x_2
mleca	gismu   \n-mec-   \n-me'a-      \nx_1 is less than x_2 in property x_3 by amount x_4
mledi	gismu   \n-led-      \nx_1 is a mould or fungus of species x_2 growing on x_3
mluni	gismu   \n-lun-      \nx_1 is a satellite orbiting x_2 with characteristics x_3 and orbital parameters x_4
mokca	gismu   \n-moc-      \nx_1 is an instant at time or place x_2
moklu	gismu   \n-mol-   \n-mo'u-      \nx_1 is a mouth of x_2
molki	gismu   \n-mlo-      \nx_1 is an industrial plant or mill performing x_2
molro	gismu   \n-mo'o-      \nx_1 is x_2 moles
morji	gismu   \n-moj-   \n-mo'i-      \nx_1 remembers x_2 about subject x_3
morko	gismu   \n-mor-      \nx_1 is Moroccan in aspect x_2
morna	gismu   \n-mon-   \n-mo'a-      \nx_1 is a pattern of x_2 arranged according to x_3
morsi	gismu   \n-mro-      \nx_1 is dead
mosra	gismu   \n-mos-      \nx_1 is friction due to rubbing between x_2 and x_3
mraji	gismu      \nx_1 is a quantity of rye of species x_2
mrilu	gismu   \n-mri-      \nx_1 mails or posts x_2 to x_3 from x_4 by x_5
mruli	gismu   \n-mru-      \nx_1 is a hammer for x_2 with head x_3 propelled by x_4
mucti	gismu   \n-mut-      \nx_1 is immaterial or not physical
mudri	gismu   \n-mud-      \nx_1 is a quantity of wood of type x_2
mukti	gismu   \n-muk-   \n-mu'i-      \nx_1 is a motive for the event x_2 caused by x_3
mulno	gismu   \n-mul-   \n-mu'o-      \nx_1 is complete in property x_2 (ka)
munje	gismu   \n-muj-   \n-mu'e-      \nx_1 is a universe of x_2 defined by x_3
mupli	gismu   \n-mup-      \nx_1 is an example of common property x_2 of set x_3
murse	gismu      \nx_1 is the twilight, dawn, or dusk of day x_2 at location x_3
murta	gismu   \n-mur-   \n-mu'a-      \nx_1 is a curtain for covering x_2 made of x_3
muslo	gismu   \n-mus-      \nx_1 is Islamic or Moslem in aspect x_2
mutce	gismu   \n-tce-      \nx_1 is extreme in x_2 towards extreme x_3
muvdu	gismu   \n-muv-   \n-mu'u-      \nx_1 moves to x_2 from x_3 over route x_4
muzga	gismu   \n-muz-      \nx_1 is a museum for preserving x_2 at location x_3
nabmi	gismu   \n-nam-      \nx_1 is a problem to x_2 in situation x_3
nakni	gismu   \n-nak-      \nx_1 is a male of species x_2 with masculine traits x_3
nalci	gismu   \n-na'i-      \nx_1 is a wing of x_2
namcu	gismu   \n-nac-   \n-na'u-      \nx_1 is a number or value
nanba	gismu   \n-nab-      \nx_1 is a quantity of bread from grains x_2
nanca	gismu   \n-na'a-      \nx_1 is x_2 years long
nandu	gismu   \n-nad-      \nx_1 is difficult or challenging for x_2
nanla	gismu      \nx_1 is a boy of age x_2 immature by standard x_3
nanmu	gismu   \n-nau-      \nx_1 is a man
nanvi	gismu   \n-nav-      \nx_1 is a billionth or 10 to the negative ninth of x_2 in dimension or aspect x_3
narge	gismu   \n-nag-      \nx_1 is a nut from plant x_2 with shell x_3 and core x_4
narju	gismu   \n-naj-      \nx_1 is orange
natfe	gismu   \n-naf-   \n-na'e-      \nx_1 contradicts or denies x_2 under logic x_3
natmi	gismu   \n-nat-   \n-nai-      \nx_1 is nation or ethnic group of people x_2
navni	gismu      \nx_1 is a quantity of inert gas of type x_2
naxle	gismu   \n-nax-   \n-xle-      \nx_1 is a channel or canal to x_2 from x_3 with route x_4
nazbi	gismu   \n-naz-   \n-zbi-      \nx_1 is the nose of x_2 with nostrils x_3
nejni	gismu   \n-nen-      \nx_1 is energy of type x_2 in form x_3
nelci	gismu   \n-nel-   \n-nei-      \nx_1 likes x_2
nenri	gismu   \n-ner-   \n-ne'i-      \nx_1 is inside x_2
nibli	gismu   \n-nib-   \n-ni'i-      \nx_1 implies x_2 under rules x_3
nicte	gismu   \n-cte-      \nx_1 is a nighttime of day x_2 at location x_3
nikle	gismu   \n-nik-      \nx_1 is a quantity of nickel
nilce	gismu   \n-ni'e-      \nx_1 is furniture at x_2 for purpose x_3
nimre	gismu      \nx_1 is a quantity of citrus of species x_2
ninmu	gismu   \n-nim-   \n-ni'u-      \nx_1 is a woman
nirna	gismu   \n-nir-      \nx_1 is a nerve or neuron of x_2
nitcu	gismu   \n-tcu-      \nx_1 needs x_2 for x_3
nivji	gismu   \n-niv-      \nx_1 knits x_2 from yarn x_3
nixli	gismu   \n-nix-   \n-xli-      \nx_1 is a girl of age x_2 immature by standard x_3
nobli	gismu   \n-nol-   \n-no'i-      \nx_1 is noble by standard x_2
norgo	experimental gismu      \nx_1 reflects Norwegian culture/nationality in aspect x_2
notci	gismu   \n-not-   \n-noi-      \nx_1 is a message about x_2 from author x_3 to x_4
nukni	gismu   \n-nuk-      \nx_1 is magenta
nupre	gismu   \n-nup-   \n-nu'e-      \nx_1 promises or threatens to do x_2 to x_3
nurma	gismu   \n-num-      \nx_1 is a rural area of x_2
nusna	experimental gismu      \nx_1 induces x_2 about x_3 from specific facts x_4
nutli	gismu   \n-nul-   \n-nu'i-      \nx_1 is neutral in matter x_2
nuzba	gismu   \n-nuz-      \nx_1 is news about x_2 from x_3 to x_4
nuzlo	experimental gismu      \nx_1 reflects New Zealand culture/nationality/geography in aspect x_2.
pacna	gismu   \n-pa'a-      \nx_1 hopes for x_2 with likelihood x_3
pagbu	gismu   \n-pag-   \n-pau-      \nx_1 is a part or piece of x_2
pagre	gismu   \n-gre-      \nx_1 penetrates barrier x_2 to x_3 from x_4
pajni	gismu   \n-pai-      \nx_1 judges matter x_2
palci	gismu   \n-pac-      \nx_1 is wicked or evil by standard x_2
palku	gismu   \n-pak-      \nx_1 are pants or trousers of material x_2
palma	experimental gismu      \nx_1 is a palm tree of species x_2
palne	gismu      \nx_1 is a tray or platter with contents x_2, made of material x_3
palpi	experimental gismu      \nx_1 touch-feels/palpates surface x_2
palta	gismu      \nx_1 is a plate or saucer made of material x_2
pambe	gismu      \nx_1 is a pump inserting fluid x_2 to x_3 from x_4 by means x_5
pamga	experimental gismu      \nx_1 is a papaya (fruit) of variety x_2
panci	gismu   \n-pan-      \nx_1 is an smell or fragrance emitted by x_2 detected by x_3
pandi	gismu   \n-pad-      \nx_1 punctuates x_2 with symbol or word x_3 with effect x_4
panje	gismu      \nx_1 is a quantity of sponge
panka	gismu      \nx_1 is a park or preserve managed by x_2 for purpose x_3
panlo	gismu   \n-pa'o-      \nx_1 is a slice of x_2
panpi	gismu   \n-pap-      \nx_1 is at peace with x_2
panra	gismu      \nx_1 parallels x_2 differing only in x_3
pante	gismu   \n-pat-      \nx_1 protests or complains about x_2 to x_3 with action x_4
panzi	gismu   \n-paz-      \nx_1 is a child of x_2
papri	gismu      \nx_1 is a page of book or document x_2
parbi	gismu   \n-pab-      \nx_1 is a ratio of x_2 with respect to quantity x_3
parji	experimental gismu      \nx_1 is a parasite of x_2.
pastu	gismu   \n-pas-      \nx_1 is a robe or gown of material x_2
patfu	gismu   \n-paf-   \n-pa'u-      \nx_1 is a father of x_2
patlu	gismu      \nx_1 is a potato of species x_2
patxu	gismu   \n-pax-      \nx_1 is a pot or sink for contents x_2 of material x_3
pelji	gismu   \n-ple-      \nx_1 is paper from source x_2
pelxu	gismu   \n-pel-      \nx_1 is yellow
pemci	gismu   \n-pem-      \nx_1 is a poem about x_2 by x_3 for x_4
penbi	gismu   \n-peb-      \nx_1 is a pen using ink x_2 applied by process x_3
pencu	gismu   \n-pec-   \n-pe'u-      \nx_1 touches x_2 with x_3 at x_4
pendo	gismu   \n-ped-   \n-pe'o-      \nx_1 is a friend to x_2
penmi	gismu   \n-pen-   \n-pe'i-      \nx_1 encounters or meets x_2 at x_3
pensi	gismu   \n-pes-   \n-pei-      \nx_1 considers or ponders x_2
perli	gismu   \n-per-      \nx_1 is a pear of species x_2
pesxu	gismu   \n-pex-      \nx_1 is paste or dough of composition x_2
petso	gismu   \n-pet-      \nx_1 is 10 to the fifteenth of x_2 in dimension or aspect x_3
pezli	gismu   \n-pez-      \nx_1 is a leaf of plant x_2
picti	gismu   \n-pic-      \nx_1 is 10 to the negative twelfth of x_2 in dimension x_3
pijne	gismu      \nx_1 is a pin for piercing x_2 of material x_3
pikci	gismu      \nx_1 pleads or begs x_2 for x_3
pikta	gismu      \nx_1 is a ticket entitling x_2 to x_3
pilda	experimental gismu      \nx_1 is pale
pilji	gismu   \n-pi'i-      \nx_1 is the product of x_2 multiplied by x_3
pilka	gismu   \n-pil-   \n-pi'a-      \nx_1 is a crust or skin of x_2
pilno	gismu   \n-pli-      \nx_1 uses x_2 for purpose x_3
pimlu	gismu   \n-pim-   \n-pi'u-      \nx_1 is a feather of x_2
pinca	gismu      \nx_1 is urine of x_2
pindi	gismu   \n-pid-      \nx_1 is poor or lacking in x_2
pinfu	gismu   \n-pif-      \nx_1 is a prisoner of x_2 restrained by x_3
pinji	gismu      \nx_1 is a clitoris or penis of x_2
pinka	gismu   \n-pik-      \nx_1 is a comment about x_2 made by x_3 to x_4
pinsi	gismu   \n-pis-      \nx_1 is a pencil or crayon with marking material x_2 supported by x_3
pinta	gismu   \n-pin-      \nx_1 is flat or horizontal in frame of reference x_2
pinxe	gismu   \n-pix-      \nx_1 drinks x_2 out of x_3
pipno	gismu   \n-pi'o-      \nx_1 is a piano or other keyboard musical instrument
pixra	gismu   \n-pir-   \n-xra-      \nx_1 is a picture of x_2 made by x_3 in medium x_4
plana	gismu      \nx_1 is fat or obese by standard x_2
platu	gismu   \n-pla-      \nx_1 plans x_2 for x_3
pleji	gismu   \n-lej-   \n-le'i-      \nx_1 pays x_2 to x_3 for x_4
plibu	gismu   \n-pib-      \nx_1 is the pubic area of x_2
plini	gismu      \nx_1 is a planet around x_2 with characteristics x_3 and orbital parameters x_4
plipe	gismu   \n-pip-   \n-pi'e-      \nx_1 jumps to x_2 from x_3 reaching height x_4 propelled by x_5
plise	gismu      \nx_1 is an apple of species x_2
plita	gismu   \n-pit-      \nx_1 is a plane defined by points x_2
plixa	gismu   \n-lix-      \nx_1 plows x_2 with tool x_3 propelled by x_4
pluja	gismu   \n-luj-      \nx_1 is complex in x_2 (ka)
pluka	gismu   \n-puk-   \n-pu'a-      \nx_1 pleases x_2
pluta	gismu   \n-lut-   \n-lu'a-      \nx_1 is a route to x_2 from x_3 via points x_4
pocli	experimental gismu      \nx_1 poses derided, vulgar, commonplace, banal qualities according to x_2 in aspect x_3\nSee {tartrpocli} for a non-experimental synonym.
polje	gismu   \n-plo-      \nx_1 folds x_2 at location x_3
polno	gismu   \n-pol-      \nx_1 is Polynesian in aspect x_2
ponjo	gismu   \n-pon-   \n-po'o-      \nx_1 is Japanese in aspect x_2
ponse	gismu   \n-pos-   \n-po'e-      \nx_1 possesses or owns x_2 under law x_3
porpi	gismu   \n-pop-   \n-po'i-      \nx_1 breaks or shatters into pieces x_2
porsi	gismu   \n-por-   \n-poi-      \nx_1 is ordered by rules x_2 on unordered set x_3
porto	gismu   \n-pot-      \nx_1 is Portuguese in aspect x_2
prali	gismu   \n-pal-      \nx_1 is a profit or benefit to x_2 resulting from x_3
prami	gismu   \n-pam-   \n-pa'i-      \nx_1 loves x_2
prane	gismu   \n-pa'e-      \nx_1 is perfect or ideal in x_2
preja	gismu   \n-pej-   \n-pe'a-      \nx_1 spreads over x_2 from initial state x_3
prenu	gismu   \n-pre-      \nx_1 is a person
preti	gismu   \n-ret-   \n-rei-      \nx_1 is a question about x_2 asked by x_3 to x_4
prije	gismu   \n-pij-      \nx_1 is wise about matter x_2 to observer x_3
prina	gismu   \n-pri-      \nx_1 is a print on x_2 using x_3
pritu	gismu      \nx_1 is to the right of x_2 in frame of reference x_3
prosa	gismu   \n-ros-   \n-ro'a-      \nx_1 is prose about x_2 by x_3 for audience x_4
pruce	gismu   \n-ruc-   \n-ru'e-      \nx_1 is a process with input x_2 and output x_3 via stages x_4
pruni	gismu   \n-pun-      \nx_1 is elastic
pruxi	gismu   \n-rux-   \n-ru'i-      \nx_1 is ghostly or spiritual
pulce	gismu   \n-puc-   \n-pu'e-      \nx_1 is dust from x_2 in or on x_3
pulji	gismu      \nx_1 is a police officer enforcing x_2
pulni	gismu      \nx_1 is a pulley used for x_2 rotating on x_3
punji	gismu   \n-puj-   \n-pu'i-      \nx_1 places or puts x_2 at x_3
punli	gismu   \n-pul-      \nx_1 is a swelling on x_2 of material x_3
purci	gismu   \n-pur-   \n-pru-      \nx_1 is earlier than or in the past of x_2
purdi	gismu   \n-pud-      \nx_1 is a garden or field tended by x_2 growing x_3
purmo	gismu   \n-pum-   \n-pu'o-      \nx_1 is a quantity of powder of x_2
racli	gismu      \nx_1 is rational or sane by standard x_2\n&quot;Logical&quot; in colloquial sense often means {racli}.
ractu	gismu      \nx_1 is a rabbit of species x_2
radno	gismu   \n-ra'o-      \nx_1 is x_2 radians
rafsi	gismu   \n-raf-      \nx_1 is an affix for word x_2 with form x_3 in language x_4
ragve	gismu   \n-rav-      \nx_1 is across boundary x_2 from x_3
rakso	gismu      \nx_1 is Iraqi in aspect x_2
raktu	gismu   \n-ra'u-      \nx_1 disturbs person x_2 causing problems x_3
ralci	gismu   \n-rac-      \nx_1 is fragile in property x_2
ralju	gismu   \n-ral-      \nx_1 is principal or chief among x_2 in property x_3
ralte	gismu   \n-ra'e-      \nx_1 keeps or retains x_2
randa	gismu   \n-rad-      \nx_1 surrenders or yields to x_2
rango	gismu   \n-rag-      \nx_1 is a bodily organ of x_2 performing function x_3
ranji	gismu   \n-ra'i-      \nx_1 persists or continues over interval x_2
ranmi	gismu   \n-ram-      \nx_1 is a myth about x_3 in mythos x_3 of culture x_4
ransu	gismu      \nx_1 is a quantity of bronze of composition x_2
ranti	gismu   \n-ran-      \nx_1 is soft to force x_2
ranxi	gismu   \n-rax-      \nx_1 is ironic or contrary to expectation x_2 in aspect x_3
ra'oi	experimental cmavo   \nRAhOI      \ntag of rafsi; it makes one following rafsi a sumti.\nNote that sometimes a space or a pause is necessary before and/or after the rafsi. The parser zantufa-0.14 and later will parse ra'oi as in selma'o RAhOI ( http://guskant.github.io/gerna_cipra/zantufa-0.14.html ). Examples: ra'oi.cra .i ra'oi.cac .i ra'oicai .i ra'oicacy .i ra'oi.gismy .i ra'oigismu .
rapli	gismu   \n-rap-      \nx_1 repeats x_2 times
rarna	gismu   \n-rar-      \nx_1 is spontaneous or natural
ratcu	gismu      \nx_1 is a rat of species x_2
ratni	gismu   \n-rat-      \nx_1 is an atom of element x_2 of isotope number x_3
rebla	gismu   \n-reb-      \nx_1 is a tail of x_2
rectu	gismu   \n-rec-   \n-re'u-      \nx_1 is a quantity of meat from x_2
remna	gismu   \n-rem-   \n-re'a-      \nx_1 is a human
renro	gismu   \n-rer-   \n-re'o-      \nx_1 throws or launches x_2 to or at x_3
renvi	gismu   \n-rev-   \n-re'i-      \nx_1 survives or endures x_2 for duration x_3
respa	gismu   \n-res-      \nx_1 is a reptile of species x_2
ricfu	gismu   \n-rif-   \n-cfu-      \nx_1 is rich in x_2
rigni	gismu   \n-rig-      \nx_1 is disgusting to x_2
rijno	gismu   \n-rij-      \nx_1 is a quantity of silver
rilti	gismu   \n-ril-      \nx_1 is a rhythm or beat of music x_2
rimni	gismu   \n-rim-      \nx_1 rhymes with x_2 in language x_3 with correspondence x_4
rinci	gismu      \nx_1 drains or flushes from x_2 through drain x_3 by force x_4
rinju	gismu   \n-ri'u-      \nx_1 is restrained by x_2 against x_3
rinka	gismu   \n-rik-   \n-ri'a-      \nx_1 causes effect x_2
rinsa	gismu      \nx_1 welcomes or greets x_2 in manner x_3\nSee also {friti} for welcome and hospitality, {coi}, {co'o}
rirci	gismu      \nx_1 is rare or unusual in property x_2 among x_3
rirni	gismu   \n-rir-      \nx_1 is a parent of x_2
rirxe	gismu   \n-ri'e-      \nx_1 is a river of land mass x_2 draining watershed x_3 into x_4
rismi	gismu   \n-ris-      \nx_1 is a quantity of rice of species x_2
risna	gismu      \nx_1 is a heart of x_2
ritli	gismu   \n-ri'i-      \nx_1 is a ceremony or rite for purpose x_2 by custom x_3 with rules x_4
rivbi	gismu   \n-riv-      \nx_1 avoids or escapes event x_2 through action x_3
rokci	gismu   \n-rok-   \n-ro'i-      \nx_1 is a quantity of rock of composition x_2 from location x_3
romge	gismu   \n-rog-      \nx_1 is a highly reflective metallic surface of metal x_2
romlo	experimental gismu      \nx_1 reflects Romani/Romany/gypsy culture/nationality/language in aspect x_2
ropno	gismu   \n-ron-   \n-ro'o-      \nx_1 is European in aspect x_2
rorci	gismu   \n-ror-      \nx_1 procreates x_2 with coparent x_3
rotsu	gismu   \n-rot-   \n-tsu-   \n-ro'u-      \nx_1 is thick in dimension x_2
rozgu	gismu   \n-roz-   \n-zgu-      \nx_1 a rose of species x_2
ruble	gismu   \n-rub-   \n-ble-      \nx_1 is weak or frail in x_2 (ka)
rufsu	gismu   \n-ruf-      \nx_1 is rough in texture
runme	gismu   \n-rum-      \nx_1 melts at temperature x_2 and pressure x_3
runta	gismu      \nx_1 dissolves in x_2 making solution x_3
rupnu	gismu   \n-rup-   \n-ru'u-      \nx_1 is measured in major money units as quantity x_2 in monetary system x_3
rusko	gismu   \n-ruk-   \n-ru'o-      \nx_1 is Russian in aspect x_2
rutni	gismu   \n-run-      \nx_1 is artificially made by people x_2
sabji	gismu   \n-sab-      \nx_1 provides x_2 to x_3
sabnu	gismu      \nx_1 is a cabin of vehicle x_2
sacki	gismu      \nx_1 is a match made of x_2
saclu	gismu      \nx_1 is the decimal equivalent of fraction x_2 in base x_3
sadjo	gismu   \n-djo-      \nx_1 is Saudi Arabian in aspect x_2
sakci	gismu   \n-sak-      \nx_1 sucks x_2 into x_3
sakli	gismu   \n-sal-      \nx_1 slides or glides on x_2
sakta	gismu   \n-sat-      \nx_1 is a quantity of sugar from source x_2 of composition x_3
salci	gismu   \n-sla-      \nx_1 celebrates x_2 with activity x_3
salpo	gismu   \n-sa'o-      \nx_1 is sloped or slanted with angle x_2 to frame x_3
salta	gismu      \nx_1 is a quantity of salad with ingredients x_2
samcu	gismu      \nx_1 is a cassava or yam of species x_2
sampu	gismu   \n-sap-      \nx_1 is simple in property x_2
sance	gismu   \n-sna-      \nx_1 is sound produced by x_2
sanga	gismu   \n-sag-   \n-sa'a-      \nx_1 sings x_2 to x_3
sanji	gismu   \n-saj-      \nx_1 is aware or conscious of x_2
sanli	gismu   \n-sa'i-      \nx_1 stands on x_2 using x_3
sanmi	gismu   \n-sai-      \nx_1 is a meal including x_2
sanso	gismu      \nx_1 is a sauce or gravy for use with x_2 containing x_3
santa	gismu      \nx_1 is an umbrella shielding x_2 from x_3, made of x_4 supported by x_5
sarcu	gismu   \n-sa'u-      \nx_1 is necessary for x_2 to continue under conditions x_3
sarji	gismu   \n-sra-      \nx_1 supports or holds up x_2 against x_3 by means x_4
sarlu	gismu      \nx_1 is a spiral or helix with limits x_2 and dimensionality x_3
sarni	experimental gismu      \nx_1 is a triangle/tetrahedron defined by set of corners/vertices x_2, sides/dimensions x_3
sarxe	gismu   \n-sax-      \nx_1 is harmonious or in agreement with x_2 in property x_3
saske	gismu   \n-ske-      \nx_1 is science about x_2 based on methodology x_3
satci	gismu      \nx_1 is exact to precision x_2 in property x_2
satre	gismu   \n-sa'e-      \nx_1 strokes x_2 with x_3
savru	gismu   \n-sav-   \n-vru-      \nx_1 is a noise to x_2 perceived with x_3
sazri	gismu   \n-saz-      \nx_1 operates machine x_2 with goal x_3
sefta	gismu   \n-sfe-      \nx_1 is a surface of object x_2 on side x_3 with edges x_4
selci	gismu   \n-sle-      \nx_1 is a cell or atom of x_2
selfu	gismu   \n-sef-   \n-se'u-      \nx_1 serves x_2 with service x_3
semto	gismu   \n-sme-      \nx_1 is Semitic in aspect x_2
senci	gismu   \n-sec-      \nx_1 sneezes
senpi	gismu   \n-sen-      \nx_1 doubts that x_2 is true
senta	gismu   \n-set-      \nx_1 is a layer of x_2 within structure x_3
senva	gismu   \n-sev-   \n-sne-      \nx_1 dreams about x_2
sepli	gismu   \n-sep-   \n-sei-      \nx_1 is separate from x_2, separated by x_3
serti	gismu   \n-ser-      \nx_1 are stairs for climbing x_2 with steps x_3
sesre	experimental gismu      \nx_1 reflects USSR (Soviet Union)/Soviet culture/Soviet nationality in aspect x_2
setca	gismu   \n-se'a-      \nx_1 inserts or puts x_2 into x_3
sevzi	gismu   \n-sez-   \n-se'i-      \nx_1 is an ego or self of x_2
sfani	gismu      \nx_1 is a fly of species x_2
sfasa	gismu   \n-sfa-      \nx_1 punishes x_2 for x_3 with punishment x_4
sfofa	gismu   \n-sfo-      \nx_1 is a sofa
sfubu	gismu   \n-sub-   \n-su'u-      \nx_1 dives or swoops to x_2 from x_3
siclu	gismu   \n-sil-      \nx_1 whistles sound x_2
sicni	gismu   \n-si'i-      \nx_1 is a coin issued by x_2 with value x_3 made of x_4
sidbo	gismu   \n-sib-   \n-si'o-      \nx_1 is an idea about x_2 by thinker x_3
sidju	gismu   \n-dju-      \nx_1 helps x_2 do x_3
sigja	gismu   \n-sig-      \nx_1 is a cigar or cigarette made of x_2 by x_3
silka	gismu   \n-sik-      \nx_1 is a quantity of silk produced by x_2
silna	gismu      \nx_1 is a quantity of salt from x_2 made of x_3
simlu	gismu   \n-mlu-      \nx_1 seems to have property x_2 to x_3
simsa	gismu   \n-smi-      \nx_1 is similar to x_2 in property or quantity x_3
simxu	gismu   \n-sim-   \n-si'u-      \nx_1 mutually do x_2
since	gismu      \nx_1 is a snake of species x_2
sinma	gismu   \n-si'a-      \nx_1 respects or venerates x_2
sinso	gismu      \nx_1 is the trigonometric sine of angle x_2
sinxa	gismu   \n-sni-      \nx_1 is a sign meaning x_2 to x_3
sipna	gismu   \n-sip-      \nx_1 is asleep
sirji	gismu   \n-sir-      \nx_1 is straight or direct between x_2 and x_3
sirxo	gismu   \n-six-      \nx_1 is Syrian in aspect x_2
sisku	gismu   \n-sis-      \nx_1 searches for property x_2 among x_3
sisti	gismu   \n-sti-      \nx_1 ceases or stops x_2
sitna	gismu   \n-sit-      \nx_1 quotes or cites source x_2 for statement x_3
sivni	gismu   \n-siv-      \nx_1 is private or personal to x_2
skaci	gismu      \nx_1 is a skirt of material x_2
skami	gismu   \n-sam-      \nx_1 is a computer for purpose x_2
skapi	gismu   \n-kap-      \nx_1 is a skin or pelt from x_2
skari	gismu   \n-ska-      \nx_1 is of color x_2 as perceived by x_3
skicu	gismu   \n-ski-      \nx_1 describes x_2 to x_3 with description x_4
skiji	gismu   \n-sij-      \nx_1 is a skate or ski for surface x_2 supporting x_3
skina	gismu   \n-kin-      \nx_1 is a movie about x_2 by film maker x_3 for x_4
skori	gismu   \n-sko-      \nx_1 is rope or cable of material x_2
skoto	gismu   \n-kot-   \n-ko'o-      \nx_1 is Scottish in aspect x_2
skuro	gismu   \n-ku'o-      \nx_1 is a groove or trench in x_2
slabu	gismu   \n-sau-      \nx_1 is familiar to x_2 in feature x_3 (ka)
slaka	gismu      \nx_1 is a syllable in language x_2
slami	gismu      \nx_1 is a quantity of acid of composition x_2
slanu	gismu      \nx_1 is a cylinder of material x_2
slari	gismu   \n-sar-      \nx_1 is sour to x_2
slasi	gismu   \n-las-      \nx_1 is a quantity of plastic of type x_2
sligu	gismu   \n-lig-      \nx_1 is solid of material x_2
slilu	gismu   \n-sli-      \nx_1 oscillates at frequency x_2 through states x_3
sliri	gismu      \nx_1 is a quantity of sulfur
slovo	gismu   \n-lov-   \n-lo'o-      \nx_1 is Slavic in aspect x_2
sluji	gismu   \n-slu-      \nx_1 is a muscle controlling x_2 of body x_3
sluni	gismu      \nx_1 is an onion of species x_2
smacu	gismu      \nx_1 is a mouse of species x_2
smadi	gismu      \nx_1 guesses x_2 is true about x_3
smaji	gismu   \n-sma-      \nx_1 is quiet at observation point x_2 by standard x_3
smaka	experimental gismu      \nx_1 feels the taste x_2
smani	gismu      \nx_1 is a monkey or ape of species x_2
smela	experimental gismu      \nx_1 is a plum/peach/cherry/apricot/almond/sloe fruit of species/variety x_2
smoka	gismu   \n-smo-      \nx_1 is a sock of material x_2
smuci	gismu   \n-muc-      \nx_1 is a spoon or scoop for use x_2 made of x_3
smuni	gismu   \n-mun-   \n-smu-      \nx_1 is a meaning of x_2 accepted by x_3
snada	gismu   \n-sad-      \nx_1 succeeds at x_2 because of effort x_3
snanu	gismu   \n-nan-      \nx_1 is to the south of x_2 in frame of reference x_3
snidu	gismu   \n-nid-      \nx_1 is x_2 seconds long
snime	gismu   \n-si'e-      \nx_1 is a quantity of snow
snipa	gismu   \n-nip-      \nx_1 sticks or adheres to x_2
snuji	gismu   \n-nuj-      \nx_1 is a sandwich of x_2 sandwiched between x_3
snura	gismu   \n-nur-   \n-nu'a-      \nx_1 is safe from threat x_2
snuti	gismu   \n-nut-      \nx_1 is an accident caused by x_2
sobde	gismu   \n-sob-   \n-so'e-      \nx_1 is a quantity of soya of species x_2
sodna	gismu      \nx_1 is a quantity of alkali metal of type x_2
sodva	gismu   \n-sod-      \nx_1 is a quantity of soda of flavor x_2
softo	gismu   \n-sof-      \nx_1 is Soviet in aspect x_2
solji	gismu   \n-slo-      \nx_1 is a quantity of gold
solri	gismu   \n-sol-      \nx_1 is the sun of home planet x_2 of race x_3
sombo	gismu   \n-som-   \n-so'o-      \nx_1 sows x_2 in x_3
sonci	gismu   \n-son-   \n-soi-      \nx_1 is a soldier of army x_2
sorcu	gismu   \n-soc-   \n-sro-      \nx_1 is a stockpile or deposit of x_2 in containment x_3
sorgu	gismu   \n-sog-      \nx_1 is sorghum of species x_2
sorta	experimental gismu      \nx_1 sorta is/does x_2 (ka), under conditions x_3\nSee also: {kinda}
sovda	gismu   \n-sov-   \n-so'a-      \nx_1 is an egg from organism x_2
spaji	gismu   \n-paj-      \nx_1 surprises x_2
spali	gismu      \nx_1 polishes x_2 with polish x_3 using tool x_4
spano	gismu   \n-san-      \nx_1 is Spanish in aspect x_2
spati	gismu   \n-spa-      \nx_1 is a plant of species x_2
speni	gismu   \n-spe-      \nx_1 is married to x_2 under custom x_3
spero	experimental gismu      \nx_1 pertains to Esperanto language/culture in aspect x_2
spisa	gismu   \n-spi-      \nx_1 is a portion or piece of x_2
spita	gismu      \nx_1 is a hospital treating patient x_2 for condition x_3
spofu	gismu   \n-pof-   \n-po'u-      \nx_1 is broken in function x_2
spoja	gismu   \n-poj-   \n-po'a-      \nx_1 explodes or bursts into pieces x_2
spuda	gismu   \n-spu-      \nx_1 responds or answers to x_2 with response x_3
sputu	gismu   \n-put-   \n-pu'u-      \nx_1 spits liquid x_2 from x_3 onto x_4
sraji	gismu   \n-raj-      \nx_1 is vertical in reference frame x_2
sraku	gismu   \n-rak-      \nx_1 scratches x_2
sralo	gismu      \nx_1 is Australian in aspect x_2
srana	gismu   \n-ra'a-      \nx_1 is relevant to x_2
srasu	gismu   \n-sas-      \nx_1 is grass of species x_2
srera	gismu   \n-sre-      \nx_1 errs in doing x_2 (ka)
srito	gismu      \nx_1 is Sanskrit in aspect x_2
sruma	gismu   \n-ru'a-      \nx_1 assumes that x_2 is true about x_3
sruri	gismu   \n-rur-   \n-sru-      \nx_1 encloses or surrounds x_2 in direction x_3
stace	gismu   \n-sac-      \nx_1 is honest to x_2 about x_3
stagi	gismu      \nx_1 is the vegetable or edible portion x_2 of plant x_3
staku	gismu   \n-tak-      \nx_1 is a quantity of ceramic made by x_2 of composition x_3 in form x_4
stali	gismu   \n-sta-      \nx_1 stays or remains at x_2
stani	gismu      \nx_1 is a stem or trunk of plant x_2
stapa	gismu   \n-tap-      \nx_1 steps on surface x_2 using limbs x_3
stasu	gismu      \nx_1 is a quantity of soup with ingredients x_2
stati	gismu      \nx_1 has talent for doing x_2
steba	gismu   \n-seb-      \nx_1 feels frustration about x_2
steci	gismu   \n-tec-   \n-te'i-      \nx_1 is specific or particular to member x_2 among set x_3
stedu	gismu   \n-sed-      \nx_1 is a head of x_2
stela	gismu   \n-tel-      \nx_1 is a lock for sealing x_2, with mechanism x_3
stero	gismu   \n-te'o-      \nx_1 is x_2 steradians
stici	gismu   \n-sic-      \nx_1 is to the west of x_2 in frame of reference x_3
stidi	gismu   \n-sid-   \n-ti'i-      \nx_1 suggests x_2 to x_3
stika	gismu   \n-tik-      \nx_1 adjusts x_2 in degree x_3
stizu	gismu   \n-tiz-      \nx_1 is a bench or chair
stodi	gismu   \n-sto-      \nx_1 is constant or unchanging in property x_2
stuna	gismu   \n-sun-      \nx_1 is to the east of x_2 in frame of reference x_3
stura	gismu   \n-tur-   \n-su'a-      \nx_1 is a structure or arrangement of x_2
stuzi	gismu   \n-tuz-   \n-stu-      \nx_1 is an inherent site of x_2
sucta	gismu   \n-suc-      \nx_1 is abstracted from x_2 by rules x_3
sudga	gismu   \n-sud-      \nx_1 is dry of liquid x_2
sufsi	experimental gismu      \nx_1 is enough in x_2 (ka/ni) for purpose x_3 (nu) to take place\nSufficient, enough. See {dukse}
sufti	gismu   \n-sfu-      \nx_1 is a hoof of x_2
suksa	gismu   \n-suk-      \nx_1 is sudden at stage x_2 in process x_3
sumji	gismu   \n-suj-      \nx_1 is the sum of x_2 plus x_3
sumne	gismu      \nx_1 smells x_2
sumti	gismu   \n-sum-   \n-su'i-      \nx_1 is an argument of predicate x_2 filling place x_3
sunga	gismu   \n-sug-      \nx_1 is a quantity of garlic of species x_2
sunla	gismu   \n-sul-      \nx_1 is a quantity of wool from x_2
surla	gismu   \n-sur-      \nx_1 relaxes by doing x_2
sutra	gismu   \n-sut-      \nx_1 is fast or quick at doing x_2
tabno	gismu   \n-tab-      \nx_1 is a quantity of carbon
tabra	gismu      \nx_1 is a horn
tadji	gismu      \nx_1 is a method for doing x_2
tadni	gismu   \n-tad-      \nx_1 is a student of x_2
tagji	gismu   \n-tag-      \nx_1 is tight on x_2 in dimension x_3 at location x_4
taksi	experimental gismu      \nx_1 is a taxi
talsa	gismu   \n-tal-      \nx_1 challenges x_2 at x_3
tamca	gismu      \nx_1 is a tomato of species x_2
tamji	gismu   \n-taj-      \nx_1 is a thumb or big toe on limb x_2 of x_3
tamne	gismu      \nx_1 is a cousin to x_2 by bond x_3
tanbo	gismu   \n-ta'o-      \nx_1 is a board or plank of material x_2
tance	gismu   \n-tac-      \nx_1 is a tongue of x_2
tanjo	gismu      \nx_1 it a tangent of angle x_2
tanko	gismu      \nx_1 is a quantity of tobacco of species x_2
tankomo	fu'ivla      \nx_1 (agent) does x_2 (property) as much as it/he/she x_3 (property of x_1 and x_2)\nSee {toltankomo}
tanru	gismu   \n-tau-      \nx_1 is a binary metaphor formed with x_2 modifying x_3, meaning x_4 in usage x_5
tansi	gismu   \n-tas-      \nx_1 is a pan or basin for contents x_2 of material x_3
tanxe	gismu   \n-tax-   \n-ta'e-      \nx_1 is a box or crate for contents x_2 made of material x_3
tapla	gismu      \nx_1 is a tile of material x_2, shape x_3, and thickness x_4
tarbi	gismu      \nx_1 is an embryo with mother x_2 and father x_3
tarci	gismu   \n-tar-      \nx_1 is a star with properties x_2
tarla	gismu      \nx_1 is a quantity of tar from source x_2
tarmi	gismu   \n-tam-   \n-tai-      \nx_1 is the shape of x_2
tarti	gismu   \n-tra-      \nx_1 behaves oneself in manner x_2
taske	gismu      \nx_1 thirsts for x_2
tasmi	experimental gismu      \nx_1 is the way or manner in which event x_2 happens
tasta	experimental gismu      \nx_1 is a taste of x_2
tatpi	gismu   \n-ta'i-      \nx_1 is tired because of x_2
tatru	gismu   \n-tat-      \nx_1 is a breast of x_2
tavla	gismu   \n-tav-   \n-ta'a-      \nx_1 talks to x_2 about x_3 in language x_4
taxfu	gismu   \n-taf-   \n-ta'u-      \nx_1 is a garment worn by x_2 serving purpose x_3
tcaci	gismu   \n-cac-      \nx_1 is a custom or habit of x_2
tcadu	gismu   \n-tca-      \nx_1 is a city or town of area x_2 in political unit x_3 serving region x_4
tcana	gismu      \nx_1 is a station of network x_2
tcati	gismu      \nx_1 is a quantity of tea brewed from x_2
tcena	gismu   \n-ten-      \nx_1 stretches to range x_2 in dimension x_3 from range x_4
tcica	gismu   \n-tic-      \nx_1 tricks or misleads x_2 into x_3
tcidu	gismu   \n-tid-      \nx_1 reads x_2 from x_3
tcika	gismu      \nx_1 is the time of x_2 happening on day x_3 at x_4
tcila	gismu   \n-til-      \nx_1 is a detail or feature of x_2
tcima	gismu   \n-tim-   \n-ti'a-      \nx_1 is weather at x_2
tcini	gismu      \nx_1 is a situation of x_2
tcita	gismu      \nx_1 is a label or tag of x_2 showing x_3
temci	gismu   \n-tem-   \n-tei-      \nx_1 is the elapsed time from x_2 to x_3
tenfa	gismu   \n-tef-      \nx_1 is the exponential result of x_2 to the power of x_3
tengu	gismu   \n-teg-   \n-te'u-      \nx_1 is a texture of x_2
terdi	gismu   \n-ted-      \nx_1 is the home planet of x_2
terpa	gismu   \n-tep-   \n-te'a-      \nx_1 fears x_2
terto	gismu   \n-tet-      \nx_1 is a trillion of x_2 in dimension or aspect x_3
tigni	gismu   \n-tig-      \nx_1 performs for audience x_2
tikpa	gismu   \n-tip-      \nx_1 kicks x_2 at location x_3 using foot x_4
tilju	gismu   \n-tij-      \nx_1 is heavy or massive by standard x_2
tinbe	gismu   \n-tib-      \nx_1 obeys rule x_2 made by x_3
tinci	gismu      \nx_1 is a quantity of tin
tinsa	gismu      \nx_1 is stiff in direction x_2 against force x_3
tirna	gismu   \n-tin-      \nx_1 hears x_2
tirse	gismu   \n-tir-      \nx_1 is a quantity of iron
tirxu	gismu      \nx_1 is a tiger of species x_2 with coat markings x_3
tisna	gismu   \n-tis-      \nx_1 fills with material x_2
titla	gismu   \n-tit-      \nx_1 is sweet or sugary to x_2
tivni	gismu   \n-tiv-      \nx_1 broadcasts x_2 via medium x_3 to receiver x_4
tixnu	gismu   \n-tix-   \n-ti'u-      \nx_1 is a daughter of x_2
toknu	gismu   \n-tok-      \nx_1 is an oven for heating x_2
toldi	gismu   \n-tod-      \nx_1 is a butterfly or moth of species x_2
tolja'e	lujvo      \nthe negation of x_1 (event/state) is a result/outcome/conclusion of antecedent x_2 (event/state). x_1 is prevented by x_2.\n{to'e} {jalge}. ``lo nu broda cu tolja'e lo nu brode'' has the same meaning as ``lo nu na broda cu jalge lo nu brode.''
tolki'u	lujvo      \nx_1 (event/state) is a reason/justification/explanation for/causing/permitting the negation of x_2 (event/state). x_1 prevents x_2.\n{to'e} {krinu}. ``lo nu broda cu tolki'u lo nu brode'' has the same meaning as ``lo nu broda cu krinu lo nu na brode.''
tolmu'i	lujvo      \nx_1 (event/state) motivates/is a motive/incentive for the negation of x_2 (event/state), per volition of x_3. x_1 prevents x_2.\n{to'e} {mukti}. ``lo nu broda cu tolmu'i lo nu brode'' has the same meaning as ``lo nu broda cu mukti lo nu na brode.''
tolni'i	lujvo      \nx_1 (event/state) logically necessitates/entails/implies the negation of x_2 (event/state), under rules/logic system x_3. x_1 prevents x_2.\n{to'e} {nibli}. ``lo nu broda cu tolni'i lo nu brode'' has the same meaning as ``lo nu broda cu nibli lo nu na brode.''
tolri'a	lujvo      \nx_1 (event/state) effects/physically causes the negation of x_2 (event/state). x_1 prevents x_2.\n{to'e} {rinka}. ``lo nu broda cu tolri'a lo nu brode'' has the same meaning as ``lo nu broda cu rinka lo nu na brode.''
tonga	gismu   \n-tog-   \n-to'a-      \nx_1 is a tone of pitch x_2 from x_3
tordu	gismu   \n-tor-   \n-to'u-      \nx_1 is short in dimension x_2 by measurement standard x_3
torni	gismu   \n-ton-   \n-to'i-      \nx_1 twists under force x_2
traji	gismu   \n-rai-      \nx_1 is superlative in property x_2 among x_3\nx4 place is the same as x3 place. See also {mutce}
trano	gismu      \nx_1 is a quantity of nitrogen
trati	gismu      \nx_1 is taut in direction x_2
trene	gismu   \n-ren-   \n-re'e-      \nx_1 is a train of cars x_2 for system x_3 propelled by x_4
tricu	gismu   \n-ric-      \nx_1 is a tree of species x_2
trina	gismu   \n-tri-      \nx_1 appeals to x_2 with property x_3
trixe	gismu   \n-rix-   \n-ti'e-      \nx_1 is behind x_2 in frame of reference x_3
troci	gismu   \n-toc-   \n-toi-      \nx_1 tries to do x_2 using method x_3
tsali	gismu   \n-tsa-      \nx_1 is strong in property x_2 (ka)
tsani	gismu   \n-tan-      \nx_1 is the sky of x_2
tsapi	gismu      \nx_1 is a spice or seasoning causing flavor x_2
tsiju	gismu   \n-tsi-      \nx_1 is a seed of organism x_2 for producing offspring x_3
tsina	gismu   \n-sin-      \nx_1 is a platform or stage at x_2 supporting x_3 made of material x_4
tubnu	gismu   \n-tu'u-      \nx_1 is tubing of material x_2 hollow of material x_3
tugni	gismu   \n-tug-   \n-tu'i-      \nx_1 agrees with x_2 that x_3 is true about x_4
tujli	gismu   \n-tuj-      \nx_1 is a tulip of species x_2
tumla	gismu   \n-tum-   \n-tu'a-      \nx_1 is terrain at x_2
tunba	gismu   \n-tub-      \nx_1 is a sibling of x_2 by bond x_3
tunka	gismu   \n-tuk-      \nx_1 is a quantity of copper
tunlo	gismu   \n-tul-   \n-tu'o-      \nx_1 swallows
tunta	gismu   \n-tun-      \nx_1 pokes or prods x_2
tuple	gismu   \n-tup-   \n-tu'e-      \nx_1 is a leg of x_2
turko	experimental gismu      \nx_1 reflects Turkish culture/nationality/language in aspect x_2
turni	gismu   \n-tru-      \nx_1 governs x_2
tutci	gismu   \n-tci-      \nx_1 is a tool used for x_2
tutra	gismu   \n-tut-      \nx_1 is territory controlled by x_2
upsi	fu'ivla      \nx_1 acknowledges making mistake x_2 (property of x1)\n{sei} {upsi} = 'Oops! Whoops!' See {srera}, {randa}, {jinvi}
vacri	gismu   \n-var-      \nx_1 is a quantity of air of planet x_2 composed of x_3
vajni	gismu   \n-vaj-   \n-vai-      \nx_1 is important to x_2 because of reason x_3
valsi	gismu   \n-val-   \n-vla-      \nx_1 is a word meaning x_2 in language x_3
vamji	gismu   \n-vam-   \n-va'i-      \nx_1 is the value of x_2 to x_3 for use x_4
vamtu	gismu   \n-vat-      \nx_1 vomits x_2
vanbi	gismu   \n-vab-      \nx_1 is part of environment x_2
vanci	gismu   \n-vac-      \nx_1 is an evening of day x_2 at x_3
vanju	gismu   \n-van-      \nx_1 is a quantity of wine from grapes x_2
vasru	gismu   \n-vas-   \n-vau-      \nx_1 is a container or vessel containing x_2
vasxu	gismu   \n-vax-   \n-va'u-      \nx_1 breathes x_2
vecnu	gismu   \n-ven-   \n-ve'u-      \nx_1 sells x_2 to x_3 for x_4
vedli	experimental gismu      \nx_1 remembers experience x_2 (li'i)
venfu	gismu   \n-vef-      \nx_1 takes revenge against x_2 because x_3 by doing x_4
vensa	gismu   \n-ves-      \nx_1 is spring of year x_2 at location x_3
verba	gismu   \n-ver-   \n-ve'a-      \nx_1 is a child aged x_2 immature by standard x_3
vibna	gismu   \n-vib-      \nx_1 is a vagina of x_2
vidni	gismu      \nx_1 is a screen or monitor for x_2
vidru	gismu   \n-vir-      \nx_1 as a virus of species x_2 capable of infecting x_3
vifne	gismu   \n-vif-      \nx_1 is fresh or unspoiled
vikmi	gismu   \n-vim-   \n-vi'i-      \nx_1 excretes waste x_2 from x_3 via x_4
viknu	gismu   \n-vik-      \nx_1 is thick or viscous
vimcu	gismu   \n-vic-   \n-vi'u-      \nx_1 removes or subtracts x_2 from x_3 leaving x_4
vindu	gismu   \n-vid-      \nx_1 is poisonous or toxic to x_2
vinji	gismu   \n-vij-      \nx_1 is an aircraft for carrying x_2 propelled by x_3
vipsi	gismu   \n-vip-      \nx_1 is a subordinate in aspect x_2 to principal x_3
virnu	gismu   \n-vri-      \nx_1 is brave in activity x_2 (ka)
viska	gismu   \n-vis-   \n-vi'a-      \nx_1 sees x_2
vitci	gismu   \n-vit-      \nx_1 is irregular in aspect x_2
vitke	gismu   \n-vi'e-      \nx_1 is a guest of x_2 at x_3
vitno	gismu   \n-vi'o-      \nx_1 is permanent in property x_2 (ka)
vlagi	gismu   \n-lag-      \nx_1 is a vulva of x_2
vlile	gismu   \n-vil-      \nx_1 is violent
vlina	gismu      \nx_1 is a logical disjunction stating that x_2 and or x_3 are true
vlipa	gismu   \n-vli-      \nx_1 has the power to bring about x_2 (nu)
vofli	gismu   \n-vol-   \n-voi-      \nx_1 flies using means x_2
voksa	gismu   \n-vok-   \n-vo'a-      \nx_1 is the voice of x_2
vorme	gismu   \n-vor-   \n-vro-      \nx_1 is a doorway between x_2 and x_3 in structure x_4
vraga	gismu   \n-vra-      \nx_1 is a lever for doing x_2 with fulcrum x_3 and arm x_4
vreji	gismu   \n-rej-   \n-vei-      \nx_1 is a record of x_2 about x_3 in medium x_4
vreta	gismu   \n-vre-      \nx_1 rests or reclines on x_2
vrici	gismu      \nx_1 is miscellaneous or assorted in property x_2
vrude	gismu   \n-vud-   \n-vu'e-      \nx_1 is virtuous by standard x_3
vrusi	gismu   \n-vus-   \n-vu'i-      \nx_1 is a taste or flavor of x_2
vukro	gismu   \n-vur-   \n-vu'o-      \nx_1 is Ukrainian in aspect x_2
xabju	gismu   \n-xa'u-      \nx_1 dwells or lives in x_2
xadba	gismu   \n-xab-      \nx_1 is half of x_2 by standard x_3
xadni	gismu   \n-xad-      \nx_1 is the body or corpse of x_2
xagji	gismu      \nx_1 is hungry for x_2
xagri	gismu      \nx_1 is a reed instrument with reed x_2
xaicku	lujvo      \nx_1 is a book damaged by/website attacked by x_2 in property x_3 (ka).\nSee also {cukta}, {xrani}.
xajmi	gismu   \n-xam-      \nx_1 is funny to x_2 in property or aspect x_3
xaksu	gismu   \n-xak-      \nx_1 consumes or uses up x_2
xalbo	gismu      \nx_1 is flippant or non-serious about x_2
xalka	gismu   \n-xal-      \nx_1 is a quantity of alcohol of type x_2 from source x_3
xalni	gismu      \nx_1 panics about x_2
xamgu	gismu   \n-xag-   \n-xau-      \nx_1 is good for x_2 by standard x_3
xampo	gismu   \n-xap-   \n-xa'o-      \nx_1 is x_2 amperes
xamsi	gismu   \n-xas-      \nx_1 is a sea or ocean on planet x_2 of fluid x_3
xance	gismu   \n-xan-   \n-xa'e-      \nx_1 is a hand of x_2
xanka	gismu      \nx_1 is nervous or anxious about x_2 (nu)
xanri	gismu   \n-xar-      \nx_1 is imaginary to x_2
xanto	gismu      \nx_1 is an elephant of species x_2
xarci	gismu   \n-xac-   \n-xa'i-      \nx_1 is a weapon for use against x_2 by x_3
xarju	gismu   \n-xaj-      \nx_1 is a pig of species x_2
xarnu	gismu      \nx_1 stubbornly opposes x_2 about x_3
xasli	gismu      \nx_1 is a donkey of species x_2
xasne	gismu      \nx_1 is sweat from x_2 excreted via x_3
xatra	gismu   \n-xa'a-      \nx_1 is a letter to x_2 from x_3 with content x_4
xatsi	gismu   \n-xat-      \nx_1 is 10 to the negative eighteenth of x_2 in dimension or aspect x_3
xazdo	gismu   \n-xaz-   \n-zdo-      \nx_1 is Asian in aspect x_2
xebni	gismu   \n-xen-   \n-xei-      \nx_1 hates or despises x_2
xebro	gismu   \n-xeb-   \n-bro-      \nx_1 is Hebrew in aspect x_2
xecto	gismu   \n-xet-   \n-cto-      \nx_1 is a hundred of x_2 in dimension or aspect x_3
xedja	gismu   \n-xej-   \n-xe'a-      \nx_1 is a jaw of x_2
xekri	gismu   \n-xek-   \n-xe'i-      \nx_1 is black
xelso	gismu   \n-xes-      \nx_1 is Greek in aspect x_2
xendo	gismu   \n-xed-   \n-xe'o-      \nx_1 is kind to x_2 in doing x_3
xenru	gismu   \n-xer-   \n-xe'u-      \nx_1 regrets x_2
xexso	gismu   \n-xex-      \nx_1 is 10 to the eighteenth of x_2 in dimension or aspect x_3
xindo	gismu   \n-xin-      \nx_1 is Hindi in aspect x_2
xinmo	gismu   \n-xim-      \nx_1 is a quantity of ink of color x_2 used by writing device x_3.
xirma	gismu   \n-xir-   \n-xi'a-      \nx_1 is a horse of species x_2
xislu	gismu   \n-xil-   \n-xi'u-      \nx_1 is a wheel of vehicle x_2 made of x_3
xispo	gismu   \n-xip-      \nx_1 is Hispanic-American in aspect x_2
xlali	gismu   \n-xla-      \nx_1 is bad for x_2 by standard x_3
xlura	gismu   \n-xlu-      \nx_1 lures or influences x_2 into x_3 by influence x_4
xorbo	experimental gismu      \nx_1 pertains to xorban language/culture in aspect x_2
xotli	gismu   \n-xol-   \n-xoi-      \nx_1 is a hotel or inn at x_2 operated by x_3
xrabo	gismu   \n-rab-      \nx_1 is Arabic in aspect x_2
xrani	gismu   \n-xai-      \nx_1 injures x_2 in property x_3 resulting in injury x_4
xriso	gismu   \n-xis-   \n-xi'o-      \nx_1 is Christian in aspect x_2
xruba	gismu   \n-xub-      \nx_1 is a quantity of buckwheat of species x_2
xruki	gismu   \n-xuk-      \nx_1 is a turkey of species x_2
xrula	gismu   \n-rul-      \nx_1 is a flower of plant or species x_2
xruti	gismu   \n-xru-      \nx_1 returns x_2 to x_3 from x_4
xukmi	gismu   \n-xum-   \n-xu'i-      \nx_1 is the chemical x_2 with purity x_3
xunre	gismu   \n-xun-   \n-xu'e-      \nx_1 is red
xurdo	gismu   \n-xur-   \n-xu'o-      \nx_1 is Urdu in aspect x_2
xusra	gismu   \n-xus-   \n-xu'a-      \nx_1 claims or asserts that x_2 is true
xutla	gismu   \n-xul-      \nx_1 is smooth
zabna	gismu   \n-zan-   \n-za'a-      \nx_1 is likable, cool in property x_2 by standard x_3\nSee also {mabla}, {xamgu}, {funca}, {vrude}, {banli}.
zajba	gismu   \n-zaj-      \nx_1 is a gymnast performing x_2
zalvi	gismu   \n-zal-      \nx_1 grinds x_2 into powder x_3
zanru	gismu   \n-zar-   \n-zau-      \nx_1 approves of x_2
zarci	gismu   \n-zac-   \n-zai-      \nx_1 is a market selling x_2 operated by x_3
zargu	gismu   \n-zag-   \n-za'u-      \nx_1 is a buttocks of x_2
zasni	gismu   \n-zas-      \nx_1 is temporary in property x_2
zasti	gismu   \n-zat-   \n-za'i-      \nx_1 exists or is real to x_2 under metaphysics x_3
zbabu	gismu   \n-bab-      \nx_1 is a quantity of soap from x_2 including composition x_3
zbani	gismu      \nx_1 is a bay of coast x_2
zbasu	gismu   \n-zba-      \nx_1 makes or assembles x_2 from parts x_3
zbepi	gismu   \n-zbe-      \nx_1 is a pedestal supporting x_2 made of x_3
zdani	gismu   \n-zda-      \nx_1 is a home of x_2
zdile	gismu   \n-zdi-      \nx_1 is amusing to x_2 in property x_3
zekri	gismu   \n-zer-   \n-zei-      \nx_1 is a crime to x_2
zenba	gismu   \n-zen-   \n-ze'a-      \nx_1 increases in x_2 by amount x_3
zepti	gismu   \n-zep-      \nx_1 is 10 to the negative twenty-first of x_2 in dimension or aspect x_3
zetro	gismu   \n-zet-      \nx_1 is 10 to the twenty-first of x_2 in dimension or aspect x_3
zgana	gismu   \n-zga-      \nx_1 observes x_2 using sense x_3
zgike	gismu   \n-zgi-   \n-gi'e-      \nx_1 is music performed by x_2
zifre	gismu   \n-zif-   \n-zi'e-      \nx_1 is at liberty or free to do or be x_2 (ka)
zinki	gismu   \n-zin-   \n-zi'i-      \nx_1 is a quantity of zinc
zirpu	gismu   \n-zir-   \n-zi'u-      \nx_1 is purple
zivle	gismu   \n-ziv-   \n-vle-      \nx_1 invests x_2 into x_3 expecting profit x_4
zmadu	gismu   \n-zma-   \n-mau-      \nx_1 exceeds or is more than x_2 in x_3 by amount x_4
zmiku	gismu   \n-zmi-      \nx_1 is automatic in function x_2
zukte	gismu   \n-zuk-   \n-zu'e-      \nx_1 takes action x_2 for purpose x_3
zumri	gismu   \n-zmu-      \nx_1 is is a quantity of corn or maize of species x_2
zungi	gismu   \n-zug-      \nx_1 feels guilt about x_2
zunle	gismu   \n-zul-      \nx_1 is to the left of x_2 in frame of reference x_3
zunti	gismu   \n-zun-   \n-zu'i-      \nx_1 interferes with or disrupts x_2 due to quality x_3
zutse	gismu   \n-zut-   \n-tse-      \nx_1 sits on x_2
zvati	gismu   \n-zva-      \nx_1 is present at x_2
+RAhOI ra'oi	tag of rafsi; it makes one following rafsi a sumti.\nNote that sometimes a space or a pause is necessary before and/or after the rafsi. The parser zantufa-0.14 and later will parse ra'oi as in selma'o RAhOI ( http://guskant.github.io/gerna_cipra/zantufa-0.14.html ). Examples: ra'oi.cra .i ra'oi.cac .i ra'oicai .i ra'oicacy .i ra'oi.gismy .i ra'oigismu .
ring	anli
ASCII character	aski
ASCII text	aski
text to be encoded to ASCII	aski
an utterance	bacru_2
an utterer	bacru
a banana	badna
a species of banana	badna_2
a saddening	badri_2
something that is sad	badri
a runner	bajra
a running gait	bajra_4
a running surface	bajra_2
limbs runs with	bajra_3
a content of a pack	bakfu_2
a pack	bakfu
something holding a pack together	bakfu_3
a cow	bakni
a species of cow	bakni_2
a form of chalk	bakri_3
a quantity of chalk	bakri
a source of chalk	bakri_2
a material of a pail	baktu_3
a pail	baktu
contents of a pail	baktu_2
a plant bulb	balji
a species of plant bulb	balji_2
a balcony	balni
a building with a balcony	balni_2
a blade	balre
a bladed tool or weapon	balre_2
something to which something is later	balvi_2
something which is later than something	balvi
bamboo	bambu
an exceeded limit	bancu_2
an exceeder	bancu
a property exceeded	bancu_4
something exceeded	bancu_3
a defender	bandu
a threat defended	bandu_3
something defended	bandu_2
an amphibian	banfi
a species of amphibian	banfi_2
a language	bangu
a user of a language	bangu_2
something expressed in a language	bangu_3
a property of greatness	banli_2
a standard of greatness	banli_3
something great	banli
a form after growth	banro_2
a form before growth	banro_3
a growing	banro
a bank	banxa
a banking function	banxa_3
a bank owner or system	banxa_2
an event's force	bapli
something forced to occur	bapli_2
a large	barda
a property of largeness	barda_2
a standard of largeness	barda_3
a material of an arch	bargu_3
an arch	bargu
something arched over or around	bargu_2
a bar	barja
a customer of a bar	barja_3
something served at a bar	barja_2
a mark	barna
a material of a mark	barna_3
something marked	barna_2
something outside	bartu
something to which something is outside	bartu_2
omnibus	basfa
an emphasizer	basna
an emphasizing action	basna_3
something emphasized	basna_2
a circumstance for replacement	basti_3
a replacement	basti
something replaced	basti_2
a biter	batci
an area being bitten	batci_3
something bitten	batci_2
something used to bite	batci_4
a button	batke
a material of a button	batke_4
purpose of a button	batke_3
something with a button	batke_2
a quantity of barley	bavmi
a species of barley	bavmi_2
a Malaysian aspect	baxso_2
something Malaysian	baxso
a foolish action or property	bebna_2
something foolish	bebna
back of body	bekpi_1
a North American aspect	bemro_2
something North American	bemro
a leader of a team	bende_3
a team	bende
people of a team	bende_2
purpose of a team	bende_4
a Bengladesh aspect	bengo_2
something Bengali	bengo
a method of transmission	benji_5
a transmission receiver	benji_3
a transmitter	benji
origin of a transmission	benji_4
something transmitted	benji_2
a son	bersa
something with a son	bersa_2
a northness reference frame	berti_3
something north	berti
something to which something is north	berti_2
a brain	besna
something with a brain	besna_2
an abdomen	betfu
something with an abdomen	betfu_2
a sufferer of a tragedy	betri_2
a tragedy	betri
a transport destination	bevri_3
a transporter	bevri
a transport origin	bevri_4
a transport route	bevri_5
something transported	bevri_2
a bead	bidju
a material of a bead	bidju_2
a bee	bifce
a species of bee	bifce_2
a lasher	bikla
an obligation	bilga_2
an obligation agreement	bilga_3
something obligated	bilga
a disease of an illness	bilma_3
a symptom of an illness	bilma_2
something ill	bilma
a purpose for regimentation	bilni_3
a regimenting system	bilni_2
something regimented	bilni
an Indonesian aspect	bindo_2
something Indonesian	bindo
an insurance benefit	binra_4
an insured threat	binra_3
an insurer	binra
something insured	binra_2
a condition for transformation	binxo_3
a transformation result	binxo_2
something that transforms	binxo_1
the transformation result	binxo_2
transform	binxo
a quantity of beer	birje
something beer is brewed from	birje_2
an arm	birka
something with an arm	birka_2
something convinced	birti
something convinced of	birti_2
a quantity of ice	bisli
something ice is made of	bisli_2
a wall	bitmu
something a wall separates	bitmu_3
something separated by a wall	bitmu_2
something with a wall	bitmu_4
bit : unit of data / information	bitni
something white	blabi
a material of glass	blaci_2
a quantity of glass	blaci
something blue	blanu
a block	bliku
a material of a block	bliku_2
a side of a block	bliku_3
a boat	bloti
a cargo of a boat	bloti_2
a propulsion of a boat	bloti_3
jeans	bluji
a ball	bolci
a material of a ball	bolci_2
a bone	bongu
a function of a bone	bongu_2
something with a bone	bongu_3
a bottle	botpi
a lid of a bottle	botpi_4
a material of a bottle	botpi_3
contents of a bottle	botpi_2
a material of a sheet	boxfo_2
a sheet	boxfo
a wave	boxna
a waveform	boxna_3
a wave frequency	boxna_5
a wavelength	boxna_4
a wave medium	boxna_2
an enemy	bradi
a struggle between enemies	bradi_3
something with an enemy	bradi_2
a material of hail	bratu_2
hail	bratu
a Brazilian aspect	brazo_2
something Brazilian	brazo
something ready	bredi
something ready for	bredi_2
a predicate	bridi_1
a predicate argument	bridi_3
a predicate relationship	bridi_2
a predicate text	bridi
a direction of a wind	brife_2
a speed of a wind	brife_3
a wind	brife
a location of an office	briju_3
an office	briju
an office worker	briju_2
a British aspect	brito_2
something British	brito
predicate variable 1	broda
predicate variable 2	brode
predicate variable 3	brodi
predicate variable 4	brodo
predicate variable 5	brodu
a bond of brotherhood	bruna_3
a brother	bruna
something with a brother	bruna_2
a Buddhist aspect	budjo_2
something Buddhist	budjo
a material of cloth	bukpu_2
a quantity of cloth	bukpu
a fog's liquid	bumru_2
something foggy	bumru
an amount of non-metric weight	bunda_2
a non-metric weight standard	bunda_3
a subunit of a non-metric weight	bunda_4
something measured in non-metric weight	bunda
something brown	bunre
a brush	burcu
a brush's bristles	burcu_3
a purpose for a brush	burcu_2
a condition for embarrassment	burna_2
something embarrassed	burna
a reference for being current	cabna_2
something current	cabna
a controller of an apparatus	cabra_3
a function of an apparatus	cabra_2
an apparatus	cabra
a number of hours	cacra_2
a standard for hour	cacra_3
something measured in hours	cacra_1
the number of hours	cacra_2
a limb used to walk	cadzu_3
a surface walked on	cadzu_2
a walker	cadzu
a standard for being frequent	cafne_2
frequent	cafne
something frequent	cafne_1
wound	cagna
a quantity of chocolate	cakla
a material of a shell	calku_3
a shell	calku
something with a shell	calku_2
a location where something vanishes	canci_2
a sense something vanished from	canci_3
a vanisher	canci
something idle	cando
a farm	cange
a farmer	cange_3
a location of a farm	cange_2
something produced by a farm	cange_4
a trader	canja
something traded	canja_2
something traded for	canja_3
something traded with	canja_4
a structure with a window	canko_2
a window	canko
a space	canlu
something occupying a space	canlu_2
a shovel	canpa
something dug with a shovel	canpa_2
a composition of sand	canre_3
a quantity of sand	canre
a source of sand	canre_2
an intestine	canti
something with intestines	canti_2
a carriage	carce
a carriage's propulsion	carce_3
something carried by a carriage	carce_2
an observer of brightness	carmi_3
a property of brightness	carmi_2
something bright	carmi
a direction of rotation	carna_3
an axis of rotation	carna_2
something that rotates	carna
a chart	cartu
a chart topic	cartu_2
data in a chart	cartu_3
something that rains	carvi
somewhere rain falls	carvi_2
somewhere rain falls from	carvi_3
a discusser	casnu
a discussion topic	casnu_2
a location of a shove	catke_3
a shover	catke
something shoved	catke_2
something looked at	catlu_2
something looking	catlu
a basis of authority	catni_3
something under authority	catni_2
something with authority	catni
a killer	catra
a method of killing	catra_3
something killed	catra_2
a direction of shallowness	caxno_2
a shallowness reference point	caxno_3
a standard of shallowness	caxno_4
something shallow	caxno_1
a launcher	cecla
a launcher's projectile	cecla_2
a launcher's propulsion	cecla_3
a community	cecmu
organisms in a community	cecmu_2
an era	cedra
an era's characterization	cedra_2
a condition of varying	cenba_4
a degree of variation	cenba_3
a property of variance	cenba_2
something varying	cenba_1
the degree of variation	cenba_3
the property of variance	cenba_2
vary	cenba
something holy	censa
something to which something is holy	censa_2
a hundreth	centi
a hundreth aspect	centi_3
something with hundreths	centi_2
an inheritance rule	cerda_4
an inheritor	cerda
something inherited	cerda_2
something with an inheritor	cerda_3
a morning	cerni
a morning's day	cerni_2
a morning's location	cerni_3
a standard of skill	certu_3
something skilled	certu_1
something skilled at	certu_2
a god	cevni
a god's dominion	cevni_3
a god's people	cevni_2
something that begins	cfari
a work of fiction	cfika
a work of fiction's author	cfika_3
a work of fiction's plot	cfika_2
a flaw	cfila
something caused by a flaw	cfila_3
something with a flaw	cfila_2
a material of a wedge	cfine_2
a wedge	cfine
a confusing property	cfipu_3
something confused	cfipu_2
something confusing	cfipu
an organism with blood	ciblu_2
blood	ciblu
something cyan	cicna
food	cidja
something that eats food	cidja_2
a hinged joint	cidni
a limb with a hinged joint	cidni_2
something with a hinged limb	cidni_3
a quantity of hydrogen	cidro
an infant	cifnu
a species of an infant	cifnu_2
a gland	cigla
a gland's secretion	cigla_2
something with a gland	cigla_3
something awake	cikna
a repairer	cikre
a use for something repaired	cikre_3
something repaired	cikre_2
an explainer	ciksi
an explanation	ciksi_4
something explained	ciksi_2
something explained to	ciksi_3
something wild	cilce
a moistening liquid	cilmo_2
something moist	cilmo
a learner	cilre
a learning method	cilre_5
a source of learning	cilre_4
a subject learned	cilre_3
something learned	cilre_2
a material of thread	cilta_2
a thread	cilta
a dimension	cimde
a dimensional model	cimde_3
something with a dimension	cimde_2
a degree of infinity	cimni_3
an infinite property	cimni_2
something infinite	cimni
a kissed place	cinba_3
a kisser	cinba
something kissed	cinba_2
an oak	cindu
a species of oak	cindu_2
a lion	cinfo
a species of lion	cinfo_2
a wrinkle	cinje
something wrinkled	cinje_2
an insect	cinki
a species of insect	cinki_2
a dimension of thinness	cinla_2
a standard of thinness	cinla_3
something thin	cinla_1
a felt emotion	cinmo_2
a subject of a felt emotion	cinmo_3
something feeling emotion	cinmo
something interested	cinri_2
something interesting	cinri
a sexual activity	cinse_2
a sexuality	cinse_3
a standard of sexuality	cinse_4
something sexual	cinse_1
a paint base	cinta_3
a paint pigment	cinta_2
paint	cinta
something pinched with tongs	cinza_3
something using tongs	cinza_2
tongs	cinza
a bird	cipni
a species of bird	cipni_2
a test	cipra
a tested property	cipra_2
something tested	cipra_3
a loser of something	cirko
a place or condition of loss	cirko_3
something lost	cirko_2
a quantity of cheese	cirla
a source of cheese	cirla_2
a writer	ciska
a writing implement	ciska_4
a writing medium	ciska_3
something written	ciska_2
a smiler	cisma
a component of a system	ciste_3
a property of a system	ciste_4
a system	ciste
a system structure	ciste_2
an eater	citka
something eaten	citka_2
a standard of youth	citno_2
something young	citno_1
a history	citri
a view-point of a history	citri_3
something with a history	citri_2
a season	citsi
a season's interval	citsi_2
a season's year	citsi_3
a flea	civla
a flea's victim	civla_3
a species of flea	civla_2
a property of strangeness	cizra_3
something strange	cizra
something to which something is strange	cizra_2
a composition of rubber	ckabu_3
a quantity of rubber	ckabu
a source of rubber	ckabu_2
a quantity of coffee	ckafi
a source of coffee	ckafi_2
a property	ckaji_2
something with a property	ckaji
a bed	ckana
a material of a bed	ckana_2
something supported by a bed	ckana_3
a dangerous condition	ckape_3
dangerous	ckape
something dangerous	ckape_1
something in danger	ckape_2
an act of ridiculing	ckasu_4
a ridiculer	ckasu
something ridiculed	ckasu_2
something ridiculed about	ckasu_3
a condition of shame	ckeji_2
an audience of something ashamed	ckeji_3
something ashamed	ckeji
a key	ckiku
a key's lock	ckiku_2
properties of a key	ckiku_3
a scale	ckilu
something measured in a scale	ckilu_2
a relationship	ckini_3
something related	ckini
something that something is related to	ckini_2
a reason for gratitude	ckire_3
a reciever of gratefulness	ckire_2
something grateful	ckire
a location of a school	ckule_2
an operator of a shcool	ckule_5
a pupil of a school	ckule_4
a school	ckule
a subject taught in a school	ckule_3
a cone of a conifer	ckunu_3
a conifer	ckunu
a species of conifer	ckunu_2
a place something is loud at	cladu_2
a standard of loudness	cladu_3
something loud	cladu_1
a dimension of longness	clani_2
a standard of longness	clani_3
something long	clani_1
a lacker	claxu
something lacked	claxu_2
a lichen	clika
a species of lichen	clika_2
something lichen grows on	clika_3
a standard for earliness	clira_2
something early	clira_1
a politely handled matter	clite_2
a standard for politeness	clite_3
something polite	clite
a leaver	cliva
a route of leaving	cliva_3
something left	cliva_2
a loop	clupa
a material of a loop	clupa_2
a mathematic	cmaci
a mathematic type	cmaci_2
a dimension of smallness	cmalu_2
a standard of smallness	cmalu_3
something small	cmalu_1
a land mass with a mountain	cmana_2
a mountain	cmana
a language of a structure word	cmavo_4
a meaning of a structure word	cmavo_3
a structure word	cmavo
a structure word's grammatical class	cmavo_2
a name	cmene
a user of a name	cmene_3
something named	cmene_2
a laugher	cmila
a member	cmima
a member's group	cmima_2
a moan	cmoni_2
a moaner	cmoni
something expressed by a moan	cmoni_3
a average's property	cnano_2
an average	cnano_1
an average's standard	cnano_4
a set of an average	cnano_3
a neck	cnebo
something with a neck	cnebo_2
a reason for a reward	cnemu_3
a reward	cnemu_4
a rewardee	cnemu_2
a rewarder	cnemu
a property of neatness	cnici_2
something neat	cnici
a feature of newness	cnino_3
an observer of newness	cnino_2
a standard of newness	cnino_4
something new	cnino_1
a quantity of lead	cnisa
a reference frame of beneathness	cnita_3
something beneath	cnita
something to which something is beneath	cnita_2
an absorber	cokcu
something absorbed	cokcu_2
something absorbed from	cokcu_3
something absorbed into	cokcu_4
a property of depth	condi_2
a reference point of depth	condi_3
a standards of depth	condi_4
something deep	condi_1
body language	corci
a feeler of pain	cortu
a location of pain	cortu_2
an acquirer	cpacu
an acquisition source	cpacu_3
something acquired	cpacu_2
a reference frame for being on top	cpana_3
something on top	cpana
something to which something is on top	cpana_2
a climber	cpare
a direction climbed	cpare_3
a surface climbed	cpare_2
a tool for climbing	cpare_4
a manner of requesting	cpedu_4
a receiver of a request	cpedu_3
a requester	cpedu
something requested	cpedu_2
a sense something is pungent to	cpina_2
something pungent	cpina
a broadcaster	cradi
a broadcasting station	cradi_3
a broadcast receiver	cradi_4
something broadcast	cradi_2
a reference frame for being in front	crane_3
something in front	crane
something to which something is in front	crane_2
a material of a shirt	creka_2
a shirt	creka
a harvested crop	crepu_2
a harvester	crepu
a source of a crop	crepu_3
a bear	cribe
a species of bear	cribe_2
a fairy	crida
a religion with a fairy	crida_2
something green	crino
a bridge	cripu
something a bridge links	cripu_4
something bridged across	cripu_2
something linked by bridge	cripu_3
a summer	crisa
a summer's location	crisa_3
a summer's year	crisa_2
an autumn	critu
an autumn's location	critu_3
an autumn's year	critu_2
a tide	ctaru
a tide's cause	ctaru_3
something with a tide	ctaru_2
a lip	ctebi
an orifice with a lip	ctebi_2
something with a lip	ctebi_3
a collector of a tax	cteki_4
a person taxed	cteki_3
a tax	cteki
something taxed	cteki_2
a quantity of petroleum	ctile
a source of petroleum	ctile_2
a light source making a shadow	ctino_3
an object with a shadow	ctino_2
a shadow	ctino
a method of teaching	ctuca_5
an audience of teaching	ctuca_2
an idea taught	ctuca_3
a subject taught	ctuca_4
a teacher	ctuca
something round	cukla
a book	cukta
a book medium	cukta_5
a book's audience	cukta_4
a book's author	cukta_3
a work in a book	cukta_2
something full	culno
something that something is full of	culno_2
a condition for something being possible	cumki_2
possible	cumki
something which is possible	cumki_1
something modest	cumla
something that something is modest about	cumla_2
a quantity of millet	cunmi
a species of nillet	cunmi_2
a condition of randomness	cunso_2
a randomness probability distribution	cunso_3
something random	cunso
an affair	cuntu
something involved in an affair	cuntu_2
a process of production	cupra_3
a producer	cupra
a product	cupra_2
a condition for allowing	curmi_3
allow	curmi
let happen	curmi
something allowed	curmi_2
something which allows	curmi_1
a species of worm	curnu_2
a worm	curnu
a property of pureness	curve_2
something pure	curve
a medium for something said	cusku_4
an audience of something said	cusku_3
a sayer	cusku
something said	cusku_2
a material of a shoe	cutci_3
a shoe	cutci
a shoe's foot	cutci_2
a chest	cutne
something with a chest	cutne_2
a chooser	cuxna
a set of choices	cuxna_3
something chosen	cuxna_2
a content of a drawer	dacru_3
a drawer	dacru
something with a drawer	dacru_2
a material object enduring in space-time; a thing	dacti
a Taoist aspect	dadjo_2
something Taoist	dadjo
a knife	dakfu
a material of a knife's blade	dakfu_3
something cut with a knife	dakfu_2
a bag	dakli
a content of a bag	dakli_2
a material of a bag	dakli_3
a fighter	damba
a reason for a fight	damba_3
something fought with	damba_2
a percussion instrument	damri
a percussion instrument's beater	damri_2
a method of suspension	dandu_3
a suspension support	dandu_2
something suspended	dandu
an answer	danfu
a problem with an answer	danfu_2
a creature	danlu
a species of a creature	danlu_2
a source of smoke	danmo_2
smoke	danmo
something applying pressure	danre
something with a pressure applied	danre_2
a dancer	dansu
a dancer's accompaniment	dansu_2
a ballistic projectile	danti
a ballistic projectile's launcher	danti_2
a material of an island	daplu_2
an island	daplu
an island's surroundings	daplu_3
a condemner	dapma
a fate condemned to	dapma_3
something condemned	dapma_2
a road	dargu
a road's destination	dargu_2
a road's origin	dargu_3
a road's route	dargu_4
an arguer	darlu
an stance argued against	darlu_3
an stance argued for	darlu_2
a property of distantness	darno_3
something distant	darno
something to which something is distant	darno_2
an audacious behaviour	darsi_2
something showing audacity	darsi
a hitter	darxi
a place hit	darxi_4
something hit	darxi_2
something used to hit	darxi_3
a pocket	daski
something with a pocket	daski_2
a type of worn garment	dasni_3
a wearer	dasni
something worn	dasni_2
a destroyer	daspo
something destroyed	daspo_2
a material of a ribbon	dasri_2
a ribbon	dasri
a duck	datka
a species of duck	datka_2
an information gathering method	datni_3
a subject of information	datni_2
information	datni
an aspect of a tenth	decti_3
a tenth	decti
something measured in tenths	decti_2
a finger or toe	degji
a limb with a finger or toe	degji_2
something with a finger or toe	degji_3
a debt	dejni_2
a debt creditor	dejni_3
a debtor	dejni
a reason for a debt	dejni_4
an amount of non-metric volume	dekpu_2
a non-metric volume standard	dekpu_3
a subunit of a non-metric volume	dekpu_4
something measured in non-metric volume	dekpu
an aspect of tens	dekto_3
something measured in tens	dekto_2
tens	dekto
a candela standard	delno_3
an amount of candela	delno_2
something measured in candela	delno_1
a legume plant	dembi_2
a legume seed	dembi
a tooth	denci
something with a tooth	denci_2
a location of density	denmi_3
a property of denseness	denmi_2
something dense	denmi
a paused state or activity	denpa_4
a pauser	denpa
a state of pause	denpa_3
something paused for	denpa_2
a composition of soil	dertu_3
a quantity of soil	dertu
a source of soil	dertu_2
a heap	derxi
a location of a heap	derxi_3
a material of a heap	derxi_2
a force causing vibration	desku_2
something vibrating	desku
a calendar of a date	detri_4
a date	detri
a location of a date	detri_3
an event with a date	detri_2
an interrupter	dicra
a reason for interruption	dicra_3
something interrupted	dicra_2
deducer	didni
an amount of electricity	dikca_3
electricity	dikca
something with electricity	dikca_2
a center of locality	diklo_2
a range of locality	diklo_3
something local	diklo
an interval of regularness	dikni_3
a property of regularness	dikni_2
something regular	dikni
a quotient	dilcu
a quotient's dividend	dilcu_2
a quotient's divisor	dilcu_3
a quotient's remainder	dilcu_4
a cloud	dilnu
a material of a cloud	dilnu_2
an air mass with a cloud	dilnu_3
an elevation of a cloud	dilnu_4
a destiny	dimna
something with a destiny	dimna_2
a building	dinju
a purpose of a building	dinju_2
a material of a nail	dinko_3
a nail	dinko
a type of nail	dinko_2
something precious	dirba
something to which something is precious	dirba_2
a condition for radiating	dirce_3
radiate	dirce
something radiated	dirce_2
something radiating	dirce_1
a drop	dirgo
a material of a drop	dirgo_2
something containing a drop	dirgo_3
period	ditcu
a lowness reference frame	dizlo_2
a standard of lowness	dizlo_3
something low	dizlo
a quantity of water	djacu
a number of full days	djedi_2
a standard defining a full day	djedi_3
something measured in full days	djedi_1
a desirer	djica
a purpose for a desire	djica_3
something desired	djica_2
a material of a ring	djine_2
an inside diameter of a ring	djine_3
an outside diameter of a ring	djine_4
a ring	djine
a fact known	djuno_2
a knower	djuno
an epistemology of knowing	djuno_4
a subject known	djuno_3
a daytime	donri
a day with a daytime	donri_2
a location with a daytime	donri_3
a German aspect	dotco_2
something German	dotco
an actor of a play	draci_5
an audience of a play	draci_4
an author of a play	draci_3
a play	draci
a plot of a play	draci_2
a property of correctness	drani_2
a situation for correctness	drani_3
a standard of correctness	drani_4
something correct	drani_1
a reference of differentness	drata_2
a standard of differentness	drata_3
something different	drata_1
a lid	drudi
something with a lid	drudi_2
a base of a logarithm	dugri_3
a logarithm	dugri
something with a logarithm	dugri_2
an excess	dukse
a standard of excess	dukse_3
excess	dukse_2
something in excess	dukse_1
too much	dukse
an opposite	dukti
a scale of an opposite	dukti_3
something with an opposite	dukti_2
a gift	dunda_2
a giver	dunda
a receiver of a gift	dunda_3
a freezing pressure	dunja_3
a freezing temperature	dunja_2
something freezing	dunja
a distressing	dunku_2
something distressed	dunku
an equal	dunli
an equality property	dunli_3
an equality reference	dunli_2
a winter	dunra
a winter location	dunra_3
a winter year	dunra_2
an ancestor	dzena
an ancestry bond	dzena_3
something with an ancestor	dzena_2
an Antarctican aspect	dzipo_2
something Antarctican	dzipo
a discoverer	facki
a discovery	facki_2
a discovery subject	facki_3
a group of typicals	fadni_3
a typical property	fadni_2
something typical	fadni
a fire	fagri
a fuel of fire	fagri_2
an oxidizer of fire	fagri_3
a sail	falnu
something gathered by a sail	falnu_2
something propelled by a sail	falnu_3
an aunt or uncle	famti
an aunt or uncle relationship	famti_3
something with an aunt or uncle	famti_2
a function	fancu
a function definition	fancu_4
a function domain	fancu_2
a function range	fancu_3
an alien property	fange_3
an foreign property	fange_3
something alien	fange
something foreign	fange_1
something to which something is alien	fange_2
something to which something is foreign	fange_2
a finish	fanmo
a finished process	fanmo_2
a factory	fanri
a factory product	fanri_2
a raw material for a factory	fanri_3
a prevented event	fanta_2
a preventer	fanta
a result of translation	fanva_5
a source language for translation	fanva_4
a source text for translation	fanva_2
a target language for translation	fanva_3
a translateer	fanva
an annoyed	fanza_2
an annoyer	fanza
an issue of opposition	fapro_3
an opponent	fapro_2
an opposeer	fapro
a destination of fall	farlu_2
a faller	farlu
a frame of reference for fall	farlu_4
an origin of fall	farlu_3
a direction	farna
an origin of a direction	farna_3
something found in a direction	farna_2
an evolution stage	farvi_4
an evolved	farvi_2
an evolver	farvi
something that evolves	farvi_3
an occurrence	fasnu
a fact	fatci
a reversed	fatne
a sequence before reversal	fatne_2
a distributed	fatri
a share of a distribution	fatri_3
something receiving a distribution	fatri_2
a boiling pressure	febvi_3
a boiling temperature	febvi_2
something boiling	febvi
a 10 to the negative fifteenth	femti
a 10 to the negative fifteenth aspect	femti_3
something with 10 to the negative fifteenths	femti_2
a division method	fendi_4
something divided	fendi_2
something divided by	fendi_3
something dividing	fendi
an anger reason	fengu_3
an anger target	fengu_2
something angry	fengu
a standard for craziness	fenki_2
something crazy	fenki_1
a crack	fenra
something with a crack	fenra_2
a sewer	fenso
a sewing thread	fenso_4
a sewing tool	fenso_3
a sewn material	fenso_2
a monetary system with money subunits	fepni_3
a quantity of money subunits	fepni_2
something measured in money subunits	fepni
a lung	fepri
something with a lung	fepri_2
something fertile	ferti
something to which something is fertile	ferti_2
something with waste	festi_2
waste	festi
a female	fetsi
a feminine trait	fetsi_3
a species of a female	fetsi_2
a fig	figre
a species of fig	figre_2
a Palestinian aspect	filso_2
something Palestinian	filso
a fish	finpe
a species of fish	finpe_2
a creater	finti
a creation	finti_2
an element in creation	finti_4
a purpose of creation	finti_3
flirter	firca
a community with a law	flalu_3
a law	flalu
a law conditions	flalu_4
a lawgiver	flalu_5
something specified by law	flalu_2
a flute	flani
a current	flecu
a current destination	flecu_3
a current source	flecu_4
something with a current	flecu_2
a failer	fliba
something failed at	fliba_2
a face	flira
something with a face	flira_2
a field	foldi
a material of a field	foldi_2
a bubble in foam	fonmo_3
a material of a foam	fonmo_2
a quantity of foam	fonmo
a telephone	fonxa
a telephone system	fonxa_2
a fork	forca
a fork base	forca_4
a prong of a fork	forca_3
a purpose of a fork	forca_2
a French aspect	fraso_2
something French	fraso
a responder	frati
a responder's stimulus	frati_3
a response	frati_2
a response condition	frati_4
respond	frati
the responder	frati_1
the responder's stimulus	frati_3
the response	frati_2
a forgiver	fraxu
a receiver of forgiveness	fraxu_2
something forgiven	fraxu_3
a difference property	frica_3
something to which something is different	frica_2
an African aspect	friko_2
something African	friko
a condition for ease	frili_3
easy	frili
something easy	frili_1
something to which something is easy	frili_2
a denominator of a fraction	frinu_3
a fraction	frinu
a numerator of a fraction	frinu_2
an offer conditions	friti_4
an offerer	friti
an offering	friti_2
something receiving offering	friti_3
a frowner	frumu
a copy	fukpi
a copying method	fukpi_4
a copy media	fukpi_3
something copied	fukpi_2
a floater	fulta
something floated on	fulta_2
something determined by fortune	funca
something with a fortune	funca_2
something that causes rotting	fusra_2
something that rots	fusra
a responsibility	fuzme_2
something holding something responsible	fuzme_3
somethings held responsible	fuzme
a language of an article	gadri_3
an article	gadri
a semantic of an article	gadri_4
something labelled by an article	gadri_2
a modification result	galfi_3
a modified	galfi_2
a modifyer	galfi
a height frame of reference	galtu_2
a high	galtu
a standard of height	galtu_3
a throat	galxe
something with a throat	galxe_2
something closed	ganlo
something inaccessible due to closure	ganlo_2
something that causes closure	ganlo_3
something that is blocked due to closure	ganlo_3
a dimension of broadness	ganra_2
a standard of broadness	ganra_3
something broad	ganra_1
a detecter	ganse_1
a detection conditions	ganse_4
a detection means	ganse_3
something detected	ganse_2
a gonad	ganti
a gonad gender	ganti_3
something with a gonad	ganti_2
an anus	ganxo
something with an anus	ganxo_2
an organisation method	ganzu_4
an organizer	ganzu
something not organized	ganzu_2
something organized	ganzu_3
a condition of gas	gapci_3
a gas	gapci_1
a gas composition	gapci_2
gas	gapci
the gas composition	gapci_2
a reference frame of aboveness	gapru_3
something above	gapru
something to which something is above	gapru_2
a material of a rail	garna_3
a rail	garna
something supported by a rail	garna_2
a cause	gasnu
something caused	gasnu_2
gua\spi	gaspo
a composition of steel	gasta_2
a quantity of steel	gasta
a root	genja
something with a root	genja_2
an Argentinian aspect	gento_2
something Argentinian	gento
a hook	genxu
a material of a hook	genxu_2
a dog	gerku
a species of dog	gerku_2
a grammar	gerna
a grammatical structure	gerna_3
something defined by a grammar	gerna_2
a guider	gidva
an event something is guided in	gidva_3
something guided	gidva_2
a billion	gigdo
a billion aspect	gigdo_3
something with billions	gigdo_2
a camp	ginka
a camp location	ginka_3
something with a camp	ginka_2
a group	girzu
a group property	girzu_2
a group relation	girzu_4
a set containing group	girzu_3
a root word	gismu
a root word affix	gismu_4
a root word argument role	gismu_3
a root word relation	gismu_2
a heat standard	glare_2
something hot	glare_1
a subject of happiness	gleki_2
something happy	gleki_1
a copulatee	gletu_2
a copulater	gletu
an English aspect	glico_2
something English	glico
a glove	gluta
a material of a glove	gluta_2
a 10 to the negative twenty-fourth	gocti
a 10 to the negative twenty-fourth aspect	gocti_3
something with 10 to the negative twenty-fourths	gocti_2
a 10 to the twenty-fourth	gotro
a 10 to the twenty-fourth aspect	gotro_3
something with 10 to the twenty-fourths	gotro_2
a unit	gradu
a unit property	gradu_3
a unit scale	gradu_2
a gram standard	grake_3
a weight in grams	grake_2
something weighed in grams	grake_1
a material of a rod	grana_2
a rod	grana
a quantity of grease	grasu
a source of grease	grasu_2
a frame	greku
something supported by a frame	greku_2
something gray	grusi
a fruit	grute
a species of fruit	grute_2
a community with something public	gubni_2
something public	gubni
a country	gugde
a people of a country	gugde_2
a territory of a country	gugde_3
mushroom	gumri
an industrial process	gundi_3
an industry	gundi
something produced by an industry	gundi_2
a work activity	gunka_2
a worker	gunka
a work goal	gunka_3
a component of an aggregate	gunma_2
an aggregate	gunma
an axle of a roller	gunro_3
a roller	gunro
a rolling surface	gunro_2
a goose	gunse
a species of goose	gunse_2
an attacker	gunta
an attack goal	gunta_3
something attacked	gunta_2
a grain	gurni
a species of grain	gurni_2
an abrader	guska
something abraded	guska_2
something abraded from	guska_3
a light	gusni
a light source	gusni_3
something illuminated by a light	gusni_2
a restaurant	gusta
a restaurant customer	gusta_3
a restaurant food	gusta_2
an amount of non-metric distance	gutci_2
a non-metric short distance standard	gutci_3
a subunit of a non-metric short distance	gutci_4
something measured in non-metric short distance	gutci
a womb	gutra
something with a womb	gutra_2
a melon	guzme
a species of melon	guzme_2
infect	infekte
have occupation	iste
-ist	iste
a means for braking	jabre_3
something braked	jabre_2
something braking	jabre
something adorned	jadni_2
something that adorns	jadni
a rocket	jakne
a rocket payload	jakne_3
something expelled by rocket jet	jakne_2
an outcome	jalge
something causing an outcome	jalge_2
a composition of starch	jalna_3
a quantity of starch	jalna
a source of starch	jalna_2
a cockroach	jalra
a species of cockroach	jalra_2
a foot	jamfu
something with a foot	jamfu_2
a reason for war	jamna_3
something at war	jamna
something at war with	jamna_2
a bell	janbe
a sound of a bell	janbe_2
a joint	janco
a limb with a joint	janco_2
something a limb is jointed to	janco_3
something collided with	janli_2
something colliding	janli
a diplomat	jansu
a diplomatic negotiation	jansu_3
a purpose of a diplomat	jansu_4
something a diplomat represents	jansu_2
a bill	janta
something billed	janta_2
something that receives a bill	janta_3
something that sends a bill	janta_4
a suburban area	jarbu
something with a suburban area	jarbu_2
a demonstrater	jarco
an audience of a demonstration	jarco_3
something demonstrated	jarco_2
a narrow dimension	jarki_2
a standard of narrowness	jarki_3
something narrow	jarki_1
an activity allowed by a passport	jaspu_4
a passport	jaspu
a passport issuer	jaspu_3
something with a passport	jaspu_2
a commander	jatna
something commanded	jatna_2
a rule	javni
a system with a rule	javni_3
something mandated by a rule	javni_2
a bomb	jbama
an explosive of a bomb	jbama_2
a berry	jbari
a species of berry	jbari_2
a place of birth	jbena_4
a time of birth	jbena_3
something born	jbena
something that gives birth	jbena_2
a borrower	jbera
an interval for which something is borrowed	jbera_4
something borrowed	jbera_2
something from which something is borrowed	jbera_3
a betweenness property	jbini_3
something between	jbini
something to which something is between	jbini_2
a firmness condition	jdari_3
a force something is firm against	jdari_2
firm : resistant	jdari
something firm	jdari_1
the force something is firm against	jdari_2
a decider	jdice
a decision	jdice_2
a matter of decision	jdice_3
a decreasing property	jdika_2
an amount of decrease	jdika_3
something decreasing	jdika
a price	jdima
something that purchases something for a price	jdima_3
something that sets a price	jdima_4
something with a price	jdima_2
money	jdini
something issuing money	jdini_2
a composition of jelly	jduli_2
a quantity of jelly	jduli
a polity	jecta
something governed by a polity	jecta_2
a number of weeks	jeftu_2
a standard of a week	jeftu_3
something lasting weeks	jeftu_1
a Judeo-Christian aspect	jegvo_2
something Judeo-Christian	jegvo
an atmosphere in which something burns	jelca_3
a temperature at which something burns	jelca_2
something that burns	jelca
a gem	jemna
a gem type	jemna_2
a material of a gem	jemna_3
something shocked	jenca_2
something shocking	jenca
a material of an axle	jendu_3
an axle	jendu
something rotating on an axle	jendu_2
an army	jenmi
an army function	jenmi_3
something served by an army	jenmi_2
an earner of salary	jerna
a salaried work	jerna_3
a salary	jerna_2
a chaseer	jersi
something chased	jersi_2
an Algerian aspect	jerxo_2
something Algerian	jerxo
a material of a needle	jesni_2
a needle	jesni
a jet	jetce
a jet source	jetce_3
a material of a jet	jetce_2
a standard for truth	jetnu_2
something true	jetnu
a claw	jgalu
something with a claw	jgalu_2
an angle	jganu
an angle segment	jganu_3
a vertex of an angle	jganu_2
a holder	jgari
a location of hold	jgari_4
something held	jgari_2
something used to hold	jgari_3
a knot	jgena
something with a knot	jgena_2
a gene	jgina
a gene trait	jgina_3
something described by gene	jgina_2
something causing pride	jgira_2
something proud	jgira
a stringed musical instrument	jgita
a stringed musical instrument's bow	jgita_2
a nearness property	jibni_3
something near	jibni
something to which something is near	jibni_2
a job	jibri
something with a job	jibri_2
a stirrer	jicla
something stirred	jicla_2
a basis	jicmu
something with a basis	jicmu_2
an intuiter	jijnu
an intuition subject	jijnu_3
something intuited	jijnu_2
an interacter	jikca
something interacted with	jikca_2
economic system	jikni
a quantity of liquor	jikru
a source of liquor	jikru_2
a composition of alkali	jilka_2
a quantity of alkali	jilka
a cause of envy	jilra_3
something envied	jilra_2
something envious	jilra
a branch	jimca
something with a branch	jimca_2
an understander	jimpe
a subject of something understood	jimpe_3
something understood	jimpe_2
a limit	jimte
a property of a limit	jimte_3
something with a limit	jimte_2
shears	jinci
something cut by shears	jinci_2
a competition with a winner	jinga_4
a prize won	jinga_2
a winner	jinga
something a prize is won from	jinga_3
a disease prevented by vaccine	jinku_3
a method of vaccination	jinku_4
a vaccine	jinku
something vaccinated	jinku_2
a composition of metal	jinme_2
a quantity of metal	jinme
a liquid something is immersed in	jinru_2
something immersed	jinru
a cleanliness standard	jinsa_3
a material something is clean of	jinsa_2
something clean	jinsa_1
a fluid in a well	jinto_2
a location of a well	jinto_3
a well	jinto
an opinion	jinvi_2
a reason for an opinion	jinvi_4
a subject of an opinion	jinvi_3
something with an opinion	jinvi
something innate	jinzi
something with an innate property	jinzi_2
a chicken	jipci
a species of chicken	jipci_2
a location of a tip	jipno_3
a tip	jipno
something with a tip	jipno_2
a horn	jirna
something horned	jirna_2
a quantity of juice	jisra
a source of juice	jisra_2
a standard of falseness	jitfa_2
something false	jitfa
a controlled activity	jitro_3
a controller	jitro
something under control	jitro_2
a weaver	jivbu
a woven product	jivbu_2
a yarn for weaving	jivbu_3
a competition	jivna_3
a competitor	jivna
an opponent in a competition	jivna_2
a prize of a competition	jivna_4
a location of a gathering	jmaji_2
an origin of a gathering	jmaji_3
something gathering	jmaji
a body of water containing shoal	jmifa_3
a material of a shoal	jmifa_2
a shoal	jmifa
a combination result	jmina_4
a combiner	jmina
something combined	jmina_2
something combined to	jmina_3
a standard of living	jmive_2
something alive	jmive_1
a Jordanian aspect	jordo_2
something Jordanian	jordo
a location of a join	jorne_3
something joined	jorne
something joined to	jorne_2
a material of table	jubme_2
a table	jubme
a table support	jubme_3
an address	judri
a system defining an address	judri_3
something with an address	judri_2
a language of a sentence	jufra_3
a sentence	jufra
a sentence topic	jufra_2
a species of spider	jukni_2
a spider	jukni
a cooked food	jukpa_2
a cooker	jukpa
a recipe for cooking	jukpa_3
a filter	julne
a filter property	julne_4
something blocked by filter	julne_3
something passed by filter	julne_2
an object of attention	jundi_2
something attentive	jundi
a Chinese aspect	jungo_2
something Chinese	jungo
a timer	junla
a timing method	junla_4
a timing precision	junla_3
a unit of time	junla_2
a topic of seriousness	junri_2
something serious	junri
a weight	junta
a weight-producing field	junta_3
something with weight	junta_2
a bacteria	jurme
a species of bacteria	jurme_2
something experiencing harshness	jursa_2
something harsh	jursa
a family of a species	jutsi_3
a genus of a species	jutsi_2
a species	jutsi
a clumsiness standard	juxre_2
clumsy event	juxre_1
something clumsy	juxre
a view	jvinu
a viewpoint	jvinu_3
something viewed	jvinu_2
a content of a cup	kabri_2
a cup	kabri
a material of a cup	kabri_3
a camera	kacma
an image type recorded by camera	kacma_2
a photographic medium used in a camera	kacma_3
a Canadian aspect	kadno_2
something Canadian	kadno
a cougher	kafke
a coughing orifice	kafke_3
something coughed	kafke_2
a company	kagni
an authority chartering a company	kagni_2
a purpose of a company	kagni_3
a danger warned of	kajde_3
a warner	kajde
someting warned	kajde_2
a purpose of a shelf	kajna_3
a shelf	kajna
something supported by a shelf	kajna_2
a condition for capability	kakne_3
be able to	kakne
capable	kakne
something capable	kakne_1
something capable of being done	kakne_2
a digger	kakpa
a digging tool	kakpa_4
something dug	kakpa_2
something dug from	kakpa_3
excrement	kalci
something producing excrement	kalci_2
something allowing access to open portal	kalri_3
something being given access by open portal	kalri_3
something given access by open portal	kalri_3
something given access to open portal	kalri_2
something open	kalri
something reachable through open portal	kalri_2
a chaotic property	kalsa_2
something chaotic	kalsa
a hunter	kalte
a purpose of a hunt	kalte_3
somethuing hunted	kalte_2
a material of a pillar	kamju_2
a pillar	kamju
a committee	kamni
a purpose of a committee	kamni_2
something with a committee	kamni_3
a group with something common	kampu_2
something common or general	kampu
a goat	kanba
a species of goat	kanba_2
a counted set	kancu_2
a counter	kancu
a count result	kancu_3
a count unit	kancu_4
a measurer of dimness	kandi_3
a property of dimness	kandi_2
something dim	kandi
a calculated value	kanji_2
a calculater	kanji
a calculation process	kanji_4
data for calculation	kanji_3
an eye	kanla
something with an eye	kanla_2
the one who expects	kanpe
a standard of health	kanro_2
something healthy	kanro
a circumstance of accompaniment	kansa_3
an accompanier	kansa
something accompanied	kansa_2
a property of a quantum particle	kantu_2
a quantum particle	kantu
a component of a conjunction	kanxe_2
a conjunction	kanxe
a conjunction element	kanxe_3
a compared property	karbi_4
a comparer	karbi
a comparison	karbi_5
something compared	karbi_2
something compared with	karbi_3
a car	karce
a car engine	karce_3
something carried in a car	karce_2
a card	karda
a card shape	karda_3
a material of a card	karda_2
a standard of expensiveness	kargu_3
something expensive	kargu_1
something to which something is expensive	kargu_2
a collar	karli
a material of a collar	karli_3
something surrounded by a collar	karli_2
a journal	karni
a journal audience	karni_4
a journal contents	karni_2
a journal publisher	karni_3
a cutter	katna
a piece resulting from a cut	katna_3
something cut	katna_2
a capturer	kavbu
a trap used for capture	kavbu_3
something captured	kavbu_2
something felt sorry about	kecti_3
something felt sorry for	kecti_2
something that feels sorry	kecti
a player	kelci
a toy played with	kelci_2
a Kelvin standard	kelvo_3
a number of Kelvins	kelvo_2
something measured in Kelvins	kelvo_1
a cancer	kenra
something cancerous	kenra_2
a location in outer space	kensa_2
outer space	kensa
a location of hair	kerfa_3
hair	kerfa
something with hair	kerfa_2
an ear	kerlo
something with an ear	kerlo_2
a South American aspect	ketco_2
something South American	ketco
a cavity	kevna
something with a cavity	kevna_2
internet	kibro
a cushioner	kicne
a material of a cushion	kicne_3
something cushioned	kicne_2
a quantity of oxygen	kijno
a thousand	kilto
a thousand aspect	kilto_3
something with thousands	kilto_2
kinda	kinda
a location of sharpness	kinli_2
something sharp	kinli
a Pakistani aspect	kisto_2
something Pakistani	kisto
a street	klaji
a street location	klaji_2
something accessed by a street	klaji_3
a reason for weeping	klaku_3
a tear wept	klaku_2
a weeper	klaku
a destination gone to	klama_2
a method of going	klama_5
an origin gone from	klama_3
a route gone by	klama_4
something going	klama
a measurement scale of a quantity	klani_3
a measurer of a quantity	klani_2
a quantity	klani
a property of a subset	klesi_3
a subset	klesi
something with a subset	klesi_2
something to which something is transparent	klina_2
something transparent	klina
a quantity of halogen	kliru
a type of halogen	kliru_2
a material of clay	kliti_2
a quantity of clay	kliti
a frame of a screw	klupe_4
a purpose of a screw	klupe_2
a screw	klupe
a screw thread	klupe_3
a location of looseness	kluza_3
something loose	kluza
something with something loose	kluza_2
a cabbage	kobli
a species of cabbage	kobli_2
a corner	kojna
a material of a corner	kojna_3
something with a corner	kojna_2
coconut	kokso
a quantity of coal	kolme
a source of coal	kolme_2
comb	kombitu
a comb	komcu
a material of a comb	komcu_2
a tine of a comb	komcu_3
a cone	konju
a cone vertex	konju_3
a material of a cone	konju_2
an edge	korbi
something bordered by an edge	korbi_3
something with an edge	korbi_2
something bent	korcu
a quantity of cork	korka
a species of cork	korka_2
a jacket	kosta
a material of a jacket	kosta_2
legal or moral right	krali
an amount of non-metric area	kramu_2
a non-metric area standard	kramu_3
a subunit of a non-metric area	kramu_4
something measured in non-metric area	kramu
an origin	krasi
something with an origin	krasi_2
a function of representation	krati_3
something represented	krati_2
something representing	krati
a number of a recurrence	krefu_3
a recurrence	krefu
something that recurs	krefu_2
a believer	krici
a subject of a belief	krici_3
something believed	krici_2
a composition of crystal	krili_2
an arrangement of crystal	krili_3
a quantity of crystal	krili
a justification	krinu
something justified	krinu_2
a yelled sound	krixa_2
a yeller	krixa
an intersection	kruca_3
something intersected	kruca_2
something intersecting	kruca
a composition of cream	kruji_2
a quantity of cream	kruji
a curve	kruvi
a location of a curve	kruvi_3
a property defining a curve	kruvi_4
something with a curve	kruvi_2
a cube	kubli
a cube dimension	kubli_2
a cube side	kubli_3
a subject of curiosity	kucli_2
something curious	kucli
something comfortable	kufra
something with which something is comfortable	kufra_2
something tasty	kukte
something to which something is tasty	kukte_2
a culture	kulnu
something with a culture	kulnu_2
a room	kumfa
a room partition	kumfa_3
something with a room	kumfa_2
a camel	kumte
a species of camel	kumte_2
a mineral	kunra
a mineral mine	kunra_3
a type of mineral	kunra_2
something empty	kunti
something that something is empty of	kunti_2
a dimension of a right-angle	kurfa_3
a right-angle	kurfa
a vertex of a right-angle	kurfa_2
a caretaker	kurji
something taken care of	kurji_2
something bitter	kurki
something to which something is bitter	kurki_2
something extended over	kuspe_2
something extending over	kuspe
a victim of cruelty	kusru_2
something cruel	kusru
a species of wolf	labno_2
a wolf	labno
glasses	lacni
a puller	lacpu
something by which something is pulled	lacpu_3
something pulled	lacpu_2
a relyer	lacri
something on which something is relied to do	lacri_3
something relied on	lacri_2
a quantity of milk	ladru
a source of milk	ladru_2
a gravity against lift	lafti_4
a lifter	lafti
a location of lifting	lafti_3
something lifted	lafti_2
a probability condition	lakne_2
likely	lakne
probable	lakne
something probable	lakne_1
a quantity of wax	lakse
a source of wax	lakse_2
old	laldo_1
a lake	lalxu
a lake location	lalxu_2
an adjacency direction	lamji_4
an adjacency property	lamji_3
something adjacent	lamji
something to which something is adjacent	lamji_2
a quantity of protein	lanbi
a type of protein	lanbi_2
a flag	lanci
a flag pattern	lanci_3
a material of a flag	lanci_4
something symbolised by a flag	lanci_2
a basket	lanka
a content of a basket	lanka_2
a material of a basket	lanka_3
an analyser	lanli
an analysis method	lanli_3
something analysed	lanli_2
a sheep	lanme
a sheep's flock	lanme_3
a species of sheep	lanme_2
a can	lante
a material of a can	lante_3
something canned	lante_2
a balancing force	lanxe_2
something balanced	lanxe
a family	lanzu
a family member	lanzu_2
a standard defining a family	lanzu_3
a craft of art	larcu_2
an art	larcu
a fastened	lasna_2
a fastener	lasna
something fastened to	lasna_3
something with which something is fastened	lasna_4
a composition of brass	lastu_2
a quantity of brass	lastu
a Latin aspect	latmo_2
something Latin	latmo
a culture to which a lotus symbolizes something	latna_4
a lotus	latna
a species of lotus	latna_2
something symbolised by a lotus	latna_3
something lazily avoided	lazni_2
something lazy	lazni
a taker	lebna
something from which something is taken	lebna_3
something taken	lebna_2
lily	lelxe_1
$x_1$ is a lily of species/strain $x_2$	lelxe
a focus of a lens	lenjo_3
a lens	lenjo
a material of a lens	lenjo_4
something focused by a lens	lenjo_2
a coldness standard	lenku_2
something cold	lenku_1
a lateness standard	lerci_2
something late	lerci
an alphabet with a symbol	lerfu_2
a symbol	lerfu
something represented by a symbol	lerfu_3
chain	lianzi_1
link of a chain	lianzi_2
a Libyan aspect	libjo_2
something Libyan	libjo
a preceder	lidne
a sequence something precedes in	lidne_3
something preceded	lidne_2
an experiencer	lifri
something experienced	lifri_2
a religion	lijda
a religious belief	lijda_3
a religious believer	lijda_2
a fluid swum in	limna_2
a swimmer	limna
a destination of lightning	lindi_2
a source of lightning	lindi_3
lightning	lindi
a line	linji
a point defining a line	linji_2
a chain	linsi
a material of a chain	linsi_2
a property of a chain's link	linsi_3
a lightness standard	linto_2
something lightweight	linto_1
a story	lisri
a story audience	lisri_4
a story plot	lisri_2
a storyteller	lisri_3
a list	liste
a list medium	liste_4
a list order	liste_3
a list sequence	liste_2
a litre standard	litce_3
a number of litres	litce_2
something measured in litres	litce_1
a condition of liquidity	litki_3
a liquid	litki_1
a material of a liquid	litki_2
liquid	litki
the material of a liquid	litki_2
a method for travel	litru_3
a route of travel	litru_2
a traveler	litru
a liver	livga
something with a liver	livga_2
a fuel	livla
something powered by fuel	livla_2
a logic system	logji
logic system	logji_1
something reasoned about with logic	logji_2
Loglandic	loglo
a Lojbanic aspect	lojbo_2
something Lojbanic	lojbo
a floor	loldi
something with a floor	loldi_2
a fox	lorxu
a species of fox	lorxu_2
a Lebanese aspect	lubno_2
something Lebanese	lubno
a compound word	lujvo
a meaning of a compound word	lujvo_2
an argument of a compound word	lujvo_3
a source metaphor of a compound word	lujvo_4
a cleaning material for washing	lumci_4
a contaminant removed by washing	lumci_3
a washer	lumci
something washed	lumci_2
something naked	lunbe
a moon	lunra
a planet with a moon	lunra_2
a pressure of condensation	lunsa_4
a site of condensation	lunsa_2
a temperature of condensation	lunsa_3
something condensing	lunsa
a derogater	mabla_3
a derogative form	mabla
property of awfullness	mabla_2
shitty	mabla_1
something derogated	mabla_2
standard of awfullness	mabla_3
a mammal	mabru
a species of mammal	mabru_2
a manual condition	macnu_3
a manual function	macnu_2
something manual	macnu_1
the manual function	macnu_2
a mature property	makcu_2
something mature	makcu
a performer of magic	makfa_3
something magical	makfa
something to which something is magical	makfa_2
a magnetic field	maksi_2
something magnetic	maksi
a church	malsi
a location of a church	malsi_3
a religion of a church	malsi_2
a mother	mamta
something with a mother	mamta_2
a feeler of awe	manci
something awe-inspiring	manci_2
an uniform property	manfo_2
something uniform	manfo
mango	mango
something dark	manku
a rule of a standard	manri_3
a standard	manri
something measured by a standard	manri_2
a property of satisfaction	mansa_3
something satisfied	mansa_2
something satisfying	mansa
an ant	manti
a species of ant	manti_2
a hat	mapku
a material of a hat	mapku_2
a quantity of cotton	mapni
a standard of compatibility	mapti_3
something compatible	mapti
something with which something is compatible	mapti_2
a shelter	marbi
a threat sheltered against	marbi_3
something sheltered	marbi_2
a propulsion of a vehicle	marce_4
a surface for a vehicle	marce_3
a vehicle	marce
something carried by a vehicle	marce_2
an ethic	marde
a situation with an ethic	marde_3
something with an ethic	marde_2
a quantity of mercury	margu
a composition of matter	marji_2
a shape of matter	marji_3
matter	marji
a quantity of hemp	marna
a species of hemp	marna_2
a crusher	marxa
a result of crushing	marxa_3
something crushed	marxa_2
something achieved slowly	masno_2
something slow	masno
a measured in months	masti_1
a month standard	masti_3
a number of months	masti_2
a mat	matci
a material of a mat	matci_2
a quantity of linen	matli
a quantity of butter	matne
a source of butter	matne_2
an engine	matra
something powered by engine	matra_2
a quantity of oats	mavji
a species of oats	mavji_2
a quantity of wheat	maxri
a species of wheat	maxri_2
a brow	mebri
something with a brow	mebri_2
a million	megdo
an aspect of a million	megdo_3
something with a million	megdo_2
a math expression	mekso
a math rule	mekso_2
an aspect of beauty	melbi_3
an observer of beauty	melbi_2
a standard of beauty	melbi_4
something beautiful	melbi
a mind	menli
something with a mind	menli_2
a bond of sisterhood	mensi_3
a sister	mensi
something with a sister	mensi_2
a number of minutes	mentu_2
a standard of minutes	mentu_3
something with a duration in minutes	mentu_1
an American aspect	merko_2
something American	merko
a measureer	merli
a measurement	merli_3
a measurement accuracy	merli_5
a measurement scale	merli_4
something measured	merli_2
a Mexican aspect	mexno_2
something Mexican	mexno
something at a middle	midju
something with a middle	midju_2
a method of ecryption	mifra_3
something encrypted	mifra
something not encrypted	mifra_2
a cure	mikce_4
a curer	mikce
an ailment to be cured	mikce_3
something cured	mikce_2
a millionth	mikri
a millionth aspect	mikri_3
something with millionths	mikri_2
a thousandth	milti
a thousandth aspect	milti_3
something with thousandths	milti_2
a mild property	milxe_2
something mild	milxe
a purpose of a command	minde_3
a function of machine	minji_2
a machine	minji
an amount of non-metric long distance	minli_2
a non-metric long distance standard	minli_4
a subunit of a non-metric long distance	minli_3
something measured in non-metric long distance	minli
a form of reflection	minra_4
an observer of a reflection	minra_3
a reflecter	minra
something reflected	minra_2
a standard for being identical	mintu_3
something identical	mintu
something to which something is identical	mintu_2
a concealer	mipri
a method of concealment	mipri_4
something concealed	mipri_2
something from which something is concealed	mipri_3
a deer	mirli
a species of deer	mirli_2
something famous	misno
something to which something is famous	misno_2
an Egyptian aspect	misro_2
something Egyptian	misro
a metre direction	mitre_3
a metre standard	mitre_4
a number of metres	mitre_2
something measured in metres	mitre_1
a mixture	mixre
an ingredient of a mixture	mixre_2
a direction something aside is facing	mlana_3
a reference frame in which something is aside	mlana_4
something aside something	mlana
something to which something is aside	mlana_2
a cat	mlatu
a species of cat	mlatu_2
an amount something is less than by	mleca_4
a property in which something is less than	mleca_3
something to which something is less than	mleca_2
something which is less than something	mleca
a mould	mledi
a species of mould	mledi_2
something mould grows on	mledi_3
a characteristic of a moon	mluni_3
an orbital parameter of a moon	mluni_4
something orbited by a moon	mluni_2
an instant	mokca
a place with an instant	mokca_2
a mouth	moklu
something with a mouth	moklu_2
an industrial plant	molki
a mole standard	molro_3
a number of moles	molro_2
something measured in moles	molro_1
a remembered subject	morji_3
a rememberer	morji
something remembered	morji_2
a Moroccan aspect	morko_2
something Moroccan	morko
a pattern	morna
a pattern structure	morna_3
something with a pattern	morna_2
something dead	morsi
friction	mosra
something causing friction by rubbing	mosra_2
something rubbed to cause friction	mosra_3
a quantity of rye	mraji
a species of rye	mraji_2
a destination of a mail	mrilu_3
a mailer	mrilu
a mailing system	mrilu_5
an origin of a mail	mrilu_4
something mailed	mrilu_2
a hammer	mruli
a head of a hammer	mruli_3
a propellant of a hammer	mruli_4
something hammered	mruli_2
something immaterial	mucti
a quantity of wood	mudri
a species of wood	mudri_2
a motivated event	mukti_2
a motive	mukti
something motivated	mukti_3
a property of completeness	mulno_2
a standard for completeness	mulno_3
complete	mulno
something complete	mulno_1
the property of completeness	mulno_2
a definition of a universe	munje_3
a domain of a universe	munje_2
a universe	munje
a common property of an example	mupli_2
an example	mupli
a set with an example	mupli_3
a day with twilight	murse_2
a location of twilight	murse_3
twilight	murse
a curtain	murta
a material of a curtain	murta_3
something obscured by a curtain	murta_2
an Islamic aspect	muslo_2
something Islamic	muslo
an extreme	mutce_3
a property of extremeness	mutce_2
something extreme	mutce
a destination of movement	muvdu_2
an origin of movement	muvdu_3
a route of movement	muvdu_4
something moving	muvdu
a location of a museum	muzga_3
a museum	muzga
something preserved at a museum	muzga_2
a problem	nabmi
a problem situation	nabmi_3
something encountering problem	nabmi_2
a male	nakni
a male trait	nakni_3
a species of male	nakni_2
a wing	nalci
something with a wing	nalci_2
a number	namcu
a quantity of bread	nanba
a source of bread	nanba_2
a number of years	nanca_2
a standard of a year	nanca_3
something measured in years	nanca_1
a condition for a difficulty	nandu_3
difficult	nandu
something difficult	nandu_1
something with a difficulty	nandu_2
a boy	nanla
an age of a boy	nanla_2
a standard of boyhood	nanla_3
a man	nanmu
a billionth	nanvi
a billionth aspect	nanvi_3
something with billionths	nanvi_2
a nut	narge
a nut kernel	narge_4
a nut shell	narge_3
a species of nut	narge_2
something orange	narju
a contradicter	natfe
a logic used to contradict	natfe_3
something contradicted	natfe_2
a nation	natmi
a people of a nation	natmi_2
a quantity of inert gas	navni
a type of inert gas	navni_2
a channel	naxle
a channel destination	naxle_2
a channel origin	naxle_3
a channel route	naxle_4
a nasal passage	nazbi_3
a nose	nazbi
something with a nose	nazbi_2
a form of energy	nejni_3
a type of energy	nejni_2
energy	nejni
a liker	nelci
something liked	nelci_2
something inside of something	nenri
something with something inside	nenri_2
an implication	nibli_2
an implier	nibli
a rule of an implication	nibli_3
a day with a night	nicte_2
a location of night	nicte_3
a night-time	nicte
a quantity of nickel	nikle
a purpose of furniture	nilce_3
furniture	nilce
something furnished	nilce_2
a quantity of citrus	nimre
a species of citrus	nimre_2
a woman	ninmu
a nerve	nirna
something with a nerve	nirna_2
a purpose of a need	nitcu_3
something needed	nitcu_2
something with a need	nitcu
a knitter	nivji
a yarn for knitting	nivji_3
something knitted	nivji_2
a girl	nixli
an age of a girl	nixli_2
a standard of girlhood	nixli_3
a noble	nobli
a standard of nobility	nobli_2
Norwegian	norgo
a message	notci
a message audience	notci_4
a message author	notci_3
a message subject	notci_2
something magenta	nukni
a promiser	nupre
something promised	nupre_2
something receiving a promise	nupre_3
a rural area	nurma
something with a rural area	nurma_2
the one who logically induces	nusna
a scale of neutrality	nutli_2
something neutral	nutli
a observer of news	nuzba_4
a source of news	nuzba_3
a subject of news	nuzba_2
news	nuzba
New Zealandish	nuzlo
a hoper	pacna
a likelihood of something hoped for	pacna_3
something hoped for	pacna_2
a part	pagbu
something with a part	pagbu_2
a destination of penetration	pagre_3
an origin of penetration	pagre_4
a penetrater	pagre
something penetrated	pagre_2
a judge	pajni
a matter judged	pajni_2
a wickedness standard	palci_2
something wicked	palci
a material of trousers	palku_2
trousers	palku
palm tree	palma
a content of a tray	palne_2
a material of a tray	palne_3
a tray	palne
the one who touch-feels	palpi
a material of a plate	palta_2
a plate	palta
a pump	pambe
a pumping destination	pambe_3
a pumping means	pambe_5
a pumping origin	pambe_4
something pumped	pambe_2
papaya	pamga
a smell	panci
something detecting a smell	panci_3
something emitting a smell	panci_2
an effect of punctuation	pandi_4
a punctuater	pandi
a punctuation	pandi_3
something punctuated	pandi_2
a quantity of sponge	panje
a manager of a park	panka_2
a park	panka
a purpose of a park	panka_3
a slice	panlo
something sliced	panlo_2
something at peace	panpi
something at peace with	panpi_2
a property in which something parallel is different	panra_3
a standard of parallelness	panra_4
something parallel to something	panra_1
something to which something is parallel	panra_2
a action of protest	pante_4
a audience of protest	pante_3
a protester	pante
a subject of protest	pante_2
an offspring	panzi
something with a offspring	panzi_2
a page	papri
something with a page	papri_2
a ratio	parbi
a reference of a ratio	parbi_3
something with a ratio	parbi_2
parasite	parji
a material of a robe	pastu_2
a robe	pastu
a father	patfu
something with a father	patfu_2
a potato	patlu
a species of potato	patlu_2
a content of a pot	patxu_2
a material of a pot	patxu_3
a pot	patxu
a paper	pelji
a source of paper	pelji_2
something yellow	pelxu
an audience of a poem	pemci_4
a poem	pemci
a subject of a poem	pemci_2
a writer of a poem	pemci_3
an ink application process of a pen	penbi_3
a pen	penbi
a pen ink	penbi_2
a location of a touch	pencu_4
a toucher	pencu
a touching implement	pencu_3
something touched	pencu_2
a friend	pendo
something with a friend	pendo_2
a location of an encounter	penmi_3
an encounterer	penmi
something encountered	penmi_2
a considered subject	pensi_2
a considerer	pensi
a pear	perli
a species of pear	perli_2
a composition of paste	pesxu_2
a paste	pesxu
a 10 to the fifteenth	petso
a 10 to the fifteenth aspect	petso_3
something with 10 to the fifteenths	petso_2
a leaf	pezli
a plant with a leaf	pezli_2
a 10 to the negative twelfth	picti
a 10 to the negative twelfth aspect	picti_3
something with 10 to the negative twelfths	picti_2
a material of a pin	pijne_3
a pin	pijne
something pierced by a pin	pijne_2
a pleader	pikci
a reason for a plea	pikci_3
something receiving a plea	pikci_2
a privilege condition of a ticket	pikta_4
a ticket	pikta_1
a ticket holder	pikta_2
something entitled by a ticket	pikta_3
the ticket holder	pikta_2
ticket	pikta
pale	pilda
something multiplied	pilji_2
something multiplied by	pilji_3
a crust	pilka
something with a crust	pilka_2
an user	pilno
a purpose something is used for	pilno_3
something used	pilno_2
a feather	pimlu
something with a feather	pimlu_2
something with urine	pinca_2
urine	pinca
something of which something is poor	pindi_2
something poor	pindi
a means of imprisonment	pinfu_3
a prisoner	pinfu
something with a prisoner	pinfu_2
a penis	pinji
something with a penis	pinji_2
a comment	pinka
an audience for a comment	pinka_4
an expresser of a comment	pinka_3
a subject of a comment	pinka_2
a lead of a pencil	pinsi_2
a material of a pencil	pinsi_3
a pencil	pinsi
a frame of reference of levelness	pinta_2
horizontal	pinta
something level	pinta_1
a drinker	pinxe
a drinking vessel	pinxe_3
something drunk	pinxe_2
a keyboard instrument	pipno
an artist of a picture	pixra_3
an art medium of a picture	pixra_4
a picture	pixra
something shown by a picture	pixra_2
an standard of fatness	plana_2
something fat	plana
a plan	platu_2
a planner	platu
something planned	platu_3
a payee	pleji_3
a payer	pleji
a payment	pleji_2
something paid for	pleji_4
a pubic area	plibu
something with a pubic area	plibu_2
a characteristic of a planet	plini_3
an orbital parameter of a planet	plini_4
a planet	plini
something a planet orbits	plini_2
a destination of a leap	plipe_2
a height of a jump	plipe_4
a leaper	plipe
an origin of a leap	plipe_3
a propulsion of a jump	plipe_5
an apple	plise
a species of apple	plise_2
a plane	plita
a point defining a plane	plita_2
a plough	plixa_3
a plougher	plixa
a propulsion of a plough	plixa_4
something ploughed	plixa_2
a complex property	pluja_2
a standard of complexity	pluja_3
complexity property	pluja_2
something complex	pluja_1
a condition of pleasure	pluka_3
pleasant	pluka
something pleasant	pluka_1
something pleased	pluka_2
a destination of a route	pluta_2
an origin of a route	pluta_3
a point on a route	pluta_4
a route	pluta
vulgar	pocli
a fold	polje_3
a folder	polje
something folded	polje_2
a Polynesian aspect	polno_2
something Polynesian	polno
a Japanese aspect	ponjo_2
something Japanese	ponjo
a law defining possession	ponse_3
a possesser	ponse
something possessed	ponse_2
a piece of something broken	porpi_2
something broken	porpi
a rule of ordering	porsi_2
something ordered	porsi
something unordered	porsi_3
a Portuguese aspect	porto_2
something Portuguese	porto
a profit	prali
a profitable activity	prali_3
something to which something is a profit	prali_2
a lover	prami
something loved	prami_2
a property of perfection	prane_2
something perfect	prane
an area something is spread over	preja_2
a state before spreading	preja_3
something spread	preja
a person	prenu
an audience of a questioner	preti_4
a question	preti
a questioner	preti_3
a subject of a question	preti_2
an observer of wiseness	prije_3
a subject of wiseness	prije_2
something wise	prije
a print	prina
a printing press	prina_3
a surface printed on	prina_2
a frame of reference in which something is to the right	pritu_3
something to the right of something	pritu
something to which something is right of	pritu_2
an audience of prose	prosa_4
an author of prose	prosa_3
a subject of prose	prosa_2
prose	prosa
a process	pruce
a process input	pruce_2
a process output	pruce_3
a process stage	pruce_4
something elastic	pruni
something spiritual	pruxi
a source of dust	pulce_2
dust	pulce
something dusty	pulce_3
a police officer	pulji
something enforced by police	pulji_2
a function of a pulley	pulni_2
an axle of a pulley	pulni_3
a pulley	pulni
a location of placement	punji_3
a placer	punji
something placed	punji_2
a location of a swelling	punli_2
a material of a swelling	punli_3
a swelling	punli
something to which something is earlier	purci_2
something which is earlier than something	purci
a garden	purdi
a gardener	purdi_2
something growing in a garden	purdi_3
a material of a powder	purmo_2
a quantity of powder	purmo
a standard of rationality	racli_2
something rational	racli_1
a rabbit	ractu
a species of rabbit	ractu_2
a number of radians	radno_2
a radian standard	radno_3
something measured in radians	radno_1
the number of radians	radno_2
a language with an affix	rafsi_4
an affix	rafsi
a property of an affix	rafsi_3
a word with an affix	rafsi_2
a boundary	ragve_2
something a boundary is across	ragve_3
something across a boundary	ragve
an Iraqi aspect	rakso_2
something Iraqi	rakso
a disturbance	raktu_3
a disturber	raktu
something disturbed	raktu_2
a property of fragility	ralci_2
something fragile	ralci
a property of principalness	ralju_3
something principal	ralju
something with a principal	ralju_2
a keeper	ralte
something kept	ralte_2
a condition of surrender	randa_3
a surrenderer	randa_1
something surrendered to	randa_2
surrend	randa
a bodily organ	rango
a function of a bodily organ	rango_3
something with an organ	rango_2
an interval of persistance	ranji_2
something persistant	ranji
a culture of a myth	ranmi_4
a myth	ranmi
a mythos of a myth	ranmi_3
a subject of a myth	ranmi_2
a composition of bronze	ransu_2
a quantity of bronze	ransu
a condition of softness	ranti_3
a force to which something is soft	ranti_2
something soft	ranti_1
the force to which something is soft	ranti_2
an aspect of irony	ranxi_3
an expectation something is ironic to	ranxi_2
something ironic	ranxi
rafsi	ra'oi
a number of repetition	rapli_2
something which repeats	rapli
something spontaneous	rarna
a rat	ratcu
a species of rat	ratcu_2
an atom	ratni
an atomic number	ratni_2
an isotope of an atom	ratni_3
a tail	rebla
something with a tail	rebla_2
a meat source	rectu_2
a quantity of meat	rectu
a human	remna
a thrower	renro
something at which something is thrown	renro_3
something thrown	renro_2
a survival interval	renvi_3
a surviver	renvi
something survived	renvi_2
a reptile	respa
a species of reptile	respa_2
something in which something is rich	ricfu_2
something rich	ricfu
a condition of disgust	rigni_3
disgusting	rigni
something disgusted	rigni_2
something disgusting	rigni_1
a quantity of silver	rijno
a rhythm	rilti
something with a rhythm	rilti_2
a language of a rhyme	rimni_3
a sound of a rhyme	rimni_4
something rhymed with	rimni_2
something that rhymes	rimni
a drain	rinci_3
a drainer	rinci
a force of draining	rinci_4
a source of drainage	rinci_2
a restraint	rinju_2
something against which something is restrained	rinju_3
something restrained	rinju
a condition of an effect	rinka_3
an effect caused	rinka_2
an effect's cause	rinka_1
effect's cause	rinka
the effect caused	rinka_2
a manner of welcome	rinsa_3
a welcomer	rinsa_1
something welcomed	rinsa_2
a group in which something is rare	rirci_3
a property of rareness	rirci_2
something rare	rirci
a parent	rirni
something with a parent	rirni_2
a destination of a river	rirxe_4
a river	rirxe
a watershed of a river	rirxe_3
something with a river	rirxe_2
a quantity of rice	rismi
a species of rice	rismi_2
a heart	risna
something with a heart	risna_2
a ceremony	ritli
a custom of a ceremony	ritli_3
a purpose of a ceremony	ritli_2
a rule of a ceremony	ritli_4
an action of avoidance	rivbi_3
an avoider	rivbi
something avoided	rivbi_2
a composition of rock	rokci_2
a location of rock	rokci_3
a rock	rokci
a metal that is reflective	romge_2
a reflective metal	romge
gypsy	romlo
an European aspect	ropno_2
something European	ropno
a co-procreater	rorci_3
a procreater	rorci
something procreated	rorci_2
a dimension of thickness	rotsu_2
a standard of thickness	rotsu_3
the dimension of thickness	rotsu_2
a rose	rozgu
a species of rose	rozgu_2
a property of weakness	ruble_2
a standard of weakness	ruble_3
something weak	ruble_1
the property of weakness	ruble_2
something rough	rufsu
a pressure of melting	runme_3
a temperature of melting	runme_2
something melting	runme
a condition of dissolving	runta_4
a solution in which something is dissolved	runta_3
something dissolved in	runta_2
something dissolving	runta_1
the solution in which something is dissolved	runta_3
a monetary system	rupnu_3
an amount of money	rupnu_2
a Russian aspect	rusko_2
something Russian	rusko
a maker of something artificial	rutni_2
something artificial	rutni
a provider	sabji
a recipient of something provided	sabji_3
something provided	sabji_2
a cabin of a vehicle	sabnu
a vehicle with a cabin	sabnu_2
a match	sacki
a material of a match	sacki_2
a base of a decimal value	saclu_3
a decimal value	saclu
a fraction equal to a decimal value	saclu_2
a Saudi Arabian aspect	sadjo_2
something Saudi Arabian	sadjo
a source of suction	sakci_3
a sucker	sakci
something sucked	sakci_2
a surface slid on	sakli_2
something sliding	sakli
a composition of sugar	sakta_3
a quantity of sugar	sakta
a source of sugar	sakta_2
a celebration	salci_3
a celebrator	salci
something celebrated	salci_2
a frame of reference of a slope	salpo_3
an angle of slope	salpo_2
something sloped	salpo
a salad	salta
a salad ingredient	salta_2
a cassava	samcu
a species of cassava	samcu_2
a simple property	sampu_2
something simple	sampu
a producer of a sound	sance_2
a sound	sance
an audience of a song	sanga_3
a singer	sanga
something sung	sanga_2
something aware of something	sanji
something of which something is aware	sanji_2
a stander	sanli
a support used for standing	sanli_3
a surface stood on	sanli_2
a meal	sanmi
a meal dish	sanmi_2
an ingredient of a sauce	sanso_3
a sauce	sanso
something accompanied by sauce	sanso_2
a material of an umbrella	santa_4
an umbrella	santa
a support of an umbrella	santa_5
something blocked by an umbrella	santa_3
something shielded by an umbrella	santa_2
a condition of necessity	sarcu_3
something necessary	sarcu
something with a necessity	sarcu_2
a means for support	sarji_4
a supporter	sarji
something supported	sarji_2
something supported against	sarji_3
a helix	sarlu
a helix dimension	sarlu_3
a helix limit	sarlu_2
triangle	sarni
a property of harmony	sarxe_3
something harmonious	sarxe
something in harmony	sarxe_2
a methodology of a science	saske_3
a science	saske
a subject of a science	saske_2
a precision of exactness	satci_2
a property of exactness	satci_3
something exact	satci
a stroker	satre
a stroking implement	satre_3
something stroked	satre_2
an experiencer of a  noise	savru_2
a noise	savru
a sense a noise is perceived with	savru_3
a goal of operating something	sazri_3
an operater	sazri
something operated	sazri_2
an edge of a surface	sefta_4
a side of a surface	sefta_3
a surface	sefta
something with a surface	sefta_2
something indivisible	selci
something with an indivisible peice	selci_2
a receiver of a service	selfu_2
a server	selfu
a service	selfu_3
a Semitic aspect	semto_2
something Semitic	semto
a sneeze	senci
a doubter	senpi
something doubted	senpi_2
a layer	senta
a layered structure	senta_3
something layered	senta_2
a dreamer	senva
something dreamed	senva_2
a separating partition	sepli_3
something kept separate	sepli
something kept separate from	sepli_2
a stairway	serti
a step of a stariway	serti_3
something climbed by stairs	serti_2
Soviet	sesre
an inserter	setca
something inserted	setca_2
something inserted into	setca_3
an ego	sevzi
something with a ego	sevzi_2
a fly	sfani
a species of fly	sfani_2
a punisher	sfasa
a punishment	sfasa_4
something punishable	sfasa_3
something punished	sfasa_2
a sofa	sfofa
a diver	sfubu
something dived from	sfubu_3
something dived to	sfubu_2
a whistler	siclu
something whistled	siclu_2
a coin	sicni
a composition of a coin	sicni_4
an issuer of a coin	sicni_2
a value of a coin	sicni_3
an idea	sidbo
an subject of an idea	sidbo_2
something with an idea	sidbo_3
a helper	sidju
a receiver of help	sidju_2
something that something is helped to do	sidju_3
a cigar	sigja
a cigar maker	sigja_3
something a cigar is made of	sigja_2
a quantity of silk	silka
a source of silk	silka_2
a composition of salt	silna_3
a quantity of salt	silna
a source of salt	silna_2
a condition of seeming to have a property	simlu_4
an observer of something seeming to have a property	simlu_3
a property which something seems to have	simlu_2
seem to be	simlu
something which seems to have a property	simlu_1
the observer of something seeming to have a property	simlu_3
the property which something seems to have	simlu_2
a property of similarity	simsa_3
something similar	simsa
something similar to	simsa_2
something done mutually	simxu_2
things mutually doing something	simxu
a snake	since
a species of snake	since_2
a respecter	sinma
something respected	sinma_2
an angle with a sine	sinso_2
a sine	sinso
a meaning of a sign	sinxa_2
an observer of a sign	sinxa_3
a sign	sinxa
something asleep	sipna
an end point of something straight	sirji_3
a start point of something straight	sirji_2
something straight	sirji
a Syrian aspect	sirxo_2
something Syrian	sirxo
a group within which something is searched for	sisku_3
a property searched for	sisku_2
a searcher	sisku
a ceaseer	sisti
something ceased	sisti_2
a purpose of a quotation	sitna_3
a quoter	sitna
something quoted	sitna_2
something private	sivni
something to which something is personal	sivni_2
a material of a skirt	skaci_2
a skirt	skaci
a computer	skami
a purpose of a computer	skami_2
a skin	skapi
a source of a skin	skapi_2
a colour	skari_2
a condition in which a colour is perceived	skari_4
color	skari_2
colored	skari
something which perceives a colour	skari_3
something with a colour	skari_1
a describer	skicu
a description	skicu_4
an audience something is described to	skicu_3
something described	skicu_2
a skate	skiji
something skated over	skiji_2
something supported by a skate	skiji_3
a film	skina
a film-maker	skina_3
a film plot	skina_2
an audience of a film	skina_4
a material of a rope	skori_2
a rope	skori
a Scottish aspect	skoto_2
something Scottish	skoto
a groove	skuro
a grooved surface	skuro_2
a feature of familiarity	slabu_3
an observer of familiarity	slabu_2
a standard of familiarity	slabu_4
something familiar	slabu_1
the feature of familiarity	slabu_3
the observer of familiarity	slabu_2
a language with a syllable	slaka_2
a syllable	slaka
a composition of acid	slami_2
a quantity of acid	slami
a cylinder	slanu
a material of a cylinder	slanu_2
something sour	slari
something to which something is sour	slari_2
a quantity of plastic	slasi
a type of plastic	slasi_2
a composition of a solid	sligu_2
a condition of solidity	sligu_3
solid	sligu
something solid	sligu_1
the composition of something solid	sligu_2
a frequency of oscillation	slilu_2
an state of oscillation	slilu_3
something oscillating	slilu
a quantity of sulphur	sliri
a Slavic aspect	slovo_2
something Slavic	slovo
a muscle	sluji
something controlled by a muscle	sluji_2
something with a muscle	sluji_3
an onion	sluni
an onion species	sluni_2
a mouse	smacu
a species of mouse	smacu_2
a guess	smadi
a subject of a guess	smadi_3
something guessed	smadi_2
an observation point for silence	smaji_2
a standard of silence	smaji_3
something silent	smaji
the one who feels the taste	smaka
a monkey	smani
a species of monkey	smani_2
plum	smela
a material of a sock	smoka_2
a sock	smoka
a material of a spoon	smuci_3
a purpose of a spoon	smuci_2
a spoon	smuci
a meaning	smuni
something that accepts a meaning	smuni_3
something with a meaning	smuni_2
a succeeder	snada
a successful effort	snada_3
something succeeded at	snada_2
a reference frame of southness	snanu_3
something that is south of something	snanu
something to which something is south	snanu_2
a number of seconds	snidu_2
a standard of a second	snidu_3
something measured in seconds	snidu_1
the number of seconds	snidu_2
a quantity of snow	snime
something sticky	snipa
something stuck to	snipa_2
a sandwich	snuji
a sandwich casing	snuji_3
a sandwich filling	snuji_2
a threat something is safe from	snura_2
something that is safe from a threat	snura
a cause of an accident	snuti_2
an accident	snuti
a quantity of soya	sobde
a species of soya	sobde_2
a type of alkali	sodna_2
a quantity of soda	sodva
a type of soda	sodva_2
a Soviet aspect	softo_2
something Soviet	softo
a quantity of gold	solji
a race a sun is home star of	solri_3
a sun	solri
a sun's planet	solri_2
a sower	sombo
a sowing location	sombo_3
something sown	sombo_2
an army with a soldier	sonci_2
a soldier	sonci
a containment of a stockpile	sorcu_3
a stockpile	sorcu
something stockpiled	sorcu_2
a species of sorghum	sorgu_2
sorghum	sorgu
sorta	sorta_1
an egg	sovda
something that makes an egg	sovda_2
something surprised	spaji_2
something surprising	spaji
a polish	spali_3
a polisher	spali
a polising tool	spali_4
something polished	spali_2
a Spanish aspect	spano_2
something Spanish	spano
a plant	spati
a species of plant	spati_2
a marriage custom	speni_3
something married	speni
something married to	speni_2
Esperantic	spero
a portion	spisa
something portioned	spisa_2
a hospital	spita
an ailment treated at a hospital	spita_3
a patient of a hospital	spita_2
a function broken	spofu_2
a fragment of an explosion	spoja_2
something exploding	spoja
a responder's stimlus	spuda_2
a destination of spit	sputu_4
a source of spit	sputu_3
a spit liquid	sputu_2
a spitter	sputu
a reference frame of verticalness	sraji_2
something vertical	sraji
a scratcher	sraku
something scratched	sraku_2
an Australian aspect	sralo_2
something Australian	sralo
something relevant	srana
something to which something is relevant	srana_2
a grass	srasu
a species of grass	srasu_2
a condition for an error	srera_3
an error	srera_2
a standard for an error	srera_4
something that errs	srera_1
the error	srera_2
a Sanskrit aspect	srito_2
something Sanskrit	srito
an assumer	sruma
a topic of assumption	sruma_3
something assumed	sruma_2
a direction of enclosure	sruri_3
something eclosed	sruri_2
something enclosing	sruri
a honest	stace
something about which something is honest	stace_3
something to which something is honest	stace_2
an edible plant	stagi
an edible portion of a plant	stagi_2
a plant with an edible portion	stagi_3
a composition of ceramic	staku_3
a form of ceramic	staku_4
a maker of ceramic	staku_2
a quantity of ceramic	staku
a place stayed at	stali_2
something staying	stali
a plant with a stem	stani_2
a stem	stani
a surface treaded on	stapa_2
a treader	stapa
a treading limb	stapa_3
a soup	stasu
a soup ingredient	stasu_2
a talent	stati_2
something talented	stati
a frustration	steba_2
something frustrated	steba
a group which has a member with a specific feature	steci_3
a specific feature	steci
something with a specific feature	steci_2
a head	stedu
something with a head	stedu_2
a lock	stela
a locking mechanism	stela_3
something locked	stela_2
a number of steradians	stero_2
a steradian standard	stero_3
something measured in steradian	stero_1
the number of steradians	stero_2
a reference frame of westness	stici_3
something to which something is west	stici_2
something which is west of something	stici
an audience of a suggestion	stidi_3
a suggested idea	stidi_2
a suggester	stidi
an adjuster	stika
an amount of adjustment	stika_3
something adjusted	stika_2
a chair	stizu
a condition of constancy	stodi_3
a constant property	stodi_2
something constant	stodi
a reference frame of eastness	stuna_3
something to which something is east	stuna_2
something which is east of something	stuna
a structure	stura
something structured	stura_2
a site	stuzi
something with a site	stuzi_2
an abstraction	sucta
a rule of abstraction	sucta_3
something abstracted	sucta_2
a liquid something is dry of	sudga_2
something dry	sudga
a hoof	sufti
something with a hoof	sufti_2
a process with something sudden	suksa_3
a stage of suddenness	suksa_2
something sudden	suksa
a total of a sum	sumji
something summed	sumji_2
something summed with	sumji_3
a smeller	sumne
something smelled	sumne_2
an argument	sumti
a place of an argument	sumti_3
a predicate of an argument	sumti_2
a quantity of garlic	sunga
a species of garlic	sunga_2
a quantity of wool	sunla
a source of wool	sunla_2
a relaxer	surla
something relaxing	surla_2
something done fast	sutra_2
something fast	sutra
a quantity of carbon	tabno
a condition of a method	tadji_3
a method	tadji_1
method	tadji
something with a method	tadji_2
a studier	tadni
something studied	tadni_2
a dimension of snugness	tagji_3
a location of snugness	tagji_4
something fitted snugly	tagji_2
something snug	tagji
taxi	taksi
a challenger	talsa
something challenged	talsa_2
something to which something is challenged	talsa_3
a species of tomato	tamca_2
a tomato	tamca
a limb with a thumb	tamji_2
a thumb	tamji
something with a thumb	tamji_3
a bond of cousinhood	tamne_3
a cousin	tamne
something with a cousin	tamne_2
a board	tanbo
a material of a board	tanbo_2
a tongue	tance
something with a tongue	tance_2
an angle with a tangent	tanjo_2
a tangent	tanjo
a quantity of tobacco	tanko
a species of tobacco	tanko_2
as much as possible	tankomo
a base of a metaphor	tanru_3
a meaning of a metaphor	tanru_4
a metaphor	tanru
a modifier of a metaphor	tanru_2
a usage of a metaphor	tanru_5
a basin	tansi
a content of a basin	tansi_2
a material of a basin	tansi_3
a box	tanxe
a content of a box	tanxe_2
a material of a box	tanxe_3
a material of a tile	tapla_2
a shape of a tile	tapla_3
a thickness of a tile	tapla_4
a tile	tapla
a father of an embryo	tarbi_3
a mother of an embryo	tarbi_2
an embryo	tarbi
a property of a star	tarci_2
a star	tarci
a quantity of tar	tarla
a source of tar	tarla_2
a shape	tarmi
something with a shape	tarmi_2
a behaver	tarti
a behaviour	tarti_2
a condition of behaviour	tarti_3
behave	tarti
behaviour	tarti_2
someone with a behaviour	tarti_1
a drink something is thirsty for	taske_2
something thirsty	taske
manner	tasmi
taste	tasta
something tired	tatpi
something tiring	tatpi_2
a breast	tatru
something with a breast	tatru_2
a language of a talk	tavla_4
a subject of a talk	tavla_3
a talker	tavla
something talked to	tavla_2
a garment	taxfu
a purpose of a garment	taxfu_3
a wearer of a garment	taxfu_2
a condition of a custom	tcaci_3
a custom	tcaci_1
custom : habit	tcaci
something with a custom	tcaci_2
a city	tcadu
an area of a city	tcadu_2
a political unit of a city	tcadu_3
a region served by a city	tcadu_4
a network station	tcana
a network with a station	tcana_2
a leaf of tea	tcati_2
a quantity of tea	tcati
a dimension of stretchiness	tcena_3
an unstretched range	tcena_4
a range of stretchiness	tcena_2
something stretchy	tcena
a tricker	tcica
something that something is tricked into	tcica_3
something tricked	tcica_2
a reader	tcidu
something read	tcidu_2
something read from	tcidu_3
a day of time	tcika_3
a location of time	tcika_4
a time	tcika
something with a time	tcika_2
a detail	tcila
something detailed	tcila_2
a location of weather	tcima_2
weather	tcima
a situation	tcini
something with a situation	tcini_2
a tag	tcita
information on a tag	tcita_3
something with a tag	tcita_2
a finish of an elapse of time	temci_3
an elapse of time	temci
a start of an elapse of time	temci_2
an exponent	tenfa_3
an exponential base	tenfa_2
something exponential	tenfa
a texture	tengu
something textured	tengu_2
a home planet	terdi
a race of a home planet	terdi_2
something causing fear	terpa_2
something fearful	terpa
a trillion	terto
a trillion aspect	terto_3
something counted in trillions	terto_2
an audience of a performance	tigni_3
a performance	tigni_2
a performer	tigni
a foot used to kick	tikpa_4
a kicker	tikpa
a location of a kick	tikpa_3
something kicked	tikpa_2
a standard of heaviness	tilju_2
something heavy	tilju
a rule obeyed	tinbe_2
something obeying	tinbe
something that makes a rule obeyed	tinbe_3
a quantity of tin	tinci
a condition of stiffness	tinsa_4
a direction of stiffness	tinsa_2
a force something is stiff against	tinsa_3
something stiff	tinsa_1
stiff	tinsa
the direction of stiffness	tinsa_2
the force something is stiff against	tinsa_3
a background noise something is heard in	tirna_3
a hearer	tirna_1
hear	tirna
something heard	tirna_2
a quantity of iron	tirse
a marking of a tiger	tirxu_3
a species of tiger	tirxu_2
a tiger	tirxu
a material of a filler	tisna_2
something becoming full	tisna
something sweet	titla
something to which something is sweet	titla_2
a medium of broadcasting	tivni_3
a receiver of a braodcast	tivni_4
a daughter	tixnu
a parent of a daughter	tixnu_2
an oven	toknu
something baked with an oven	toknu_2
a moth	toldi
a species of moth	toldi_2
prevented by	tolja'e
prevent : reason	tolki'u
prevent : motive	tolmu'i
prevent : logically	tolni'i
prevent : physically cause	tolri'a
a tone	tonga
a tone pitch	tonga_2
a tone source	tonga_3
a dimension of shortness	tordu_2
a standard of shortness	tordu_3
something short	tordu
a twisting force	torni_2
something twisting	torni
a set with a superlative member	traji_4
a superlative extreme	traji_3
a superlative property	traji_2
something superlative	traji_1
a quantity of nitrogen	trano
a direction of tautness	trati_2
something taut	trati
a car of a train	trene_2
a propulsion of a train	trene_4
a system of a train	trene_3
a train	trene
a species of tree	tricu_2
a tree	tricu
a property of attractiveness	trina_3
something attracted	trina_2
something attractive	trina
a reference frame for being behind	trixe_3
something behind something	trixe
something to which something is behind	trixe_2
a method of trial	troci_3
a tryer	troci
something tried	troci_2
a property of strength	tsali_2
a standard of strength	tsali_3
something strong	tsali_1
the property of strength	tsali_2
a place with a sky	tsani_2
a sky	tsani
a seasoning	tsapi
a seasoning flavour	tsapi_2
an offspring from a seed	tsiju_3
an organism with a seed	tsiju_2
a seed	tsiju
a location of a platform	tsina_2
a material of a platform	tsina_4
a platform	tsina
something supported by a platform	tsina_3
a content of a tube	tubnu_3
a material of a tube	tubnu_2
a tube	tubnu
an agreed view	tugni_3
an agreer	tugni
a topic of agreement	tugni_4
something agreed with	tugni_2
a species of tulip	tujli_2
a tulip	tujli
a location of terrain	tumla_2
terrain	tumla
a parent of a sibling	tunba_3
a sibling	tunba
something with a sibling	tunba_2
a quantity of copper	tunka
a swallower	tunlo
something swallowed	tunlo_2
a poker	tunta
something poked	tunta_2
a leg	tuple
something with a leg	tuple_2
Turkish	turko
a governer	turni
something governed	turni_2
a purpose of a tool	tutci_2
a tool	tutci
a controller of territory	tutra_2
territory	tutra
feel oops	upsi
feel whoops	upsi
a composition of air	vacri_3
a planet with air	vacri_2
a quantity of air	vacri
a reason of importance	vajni_3
something important	vajni
something to which something is important	vajni_2
a language of a word	valsi_3
a meaning of a word	valsi_2
a word	valsi
a use of something with value	vamji_4
a value	vamji
something to which something is a value	vamji_3
something with a value	vamji_2
a vomiter	vamtu
vomit	vamtu_2
an environment	vanbi_2
a part of an environment	vanbi
a day with an evening	vanci_2
a location of an evening	vanci_3
an evening	vanci
a grape wine is made from	vanju_2
a quantity of wine	vanju
a container	vasru
something in a container	vasru_2
a breather	vasxu
something breathed	vasxu_2
a price of something sold	vecnu_4
a seller	vecnu
something sold	vecnu_2
something to which something is sold	vecnu_3
the one who remembers their experience	vedli
an act of vengeance	venfu_4
a reason for revenge	venfu_3
a taker of revenge	venfu
a victim of revenge	venfu_2
a location of spring	vensa_3
a springtime	vensa
a year of springtime	vensa_2
a child	verba
an age of a child	verba_2
a standard of childhood	verba_3
a vagina	vibna
something with a vagina	vibna_2
a function of a screen	vidni_2
a screen	vidni
a species of virus	vidru_2
a virus	vidru
something susceptible to virus	vidru_3
something fresh	vifne
a means of excretion	vikmi_4
an excreted waste	vikmi_2
an excreter of waste	vikmi
a source of excreted waste	vikmi_3
a condition of thickness	viknu_2
something thick	viknu_1
thick	viknu
a remover	vimcu
a source of removal	vimcu_3
something remaining after a removal	vimcu_4
something removed	vimcu_2
something poisonous	vindu
something to which something is poisonous	vindu_2
a cargo of an aircraft	vinji_2
an aircraft	vinji
a propulsion of an aircraft	vinji_3
a subordinate	vipsi
a subordinate aspect	vipsi_2
something to which something is subordinate	vipsi_3
a standard of bravery	virnu_3
something brave	virnu_1
something done bravely	virnu_2
a condition of seeing	viska_3
a seer	viska_1
see	viska
something seen	viska_2
an irregular property	vitci_2
something irregular	vitci
a guest	vitke
a place with a guest	vitke_3
something with a guest	vitke_2
a property of permanence	vitno_2
a standard of permanence	vitno_3
something permanent	vitno_1
the property of permanence	vitno_2
a vulva	vlagi
something with a vulva	vlagi_2
a violent act	vlile
a logical disjunction	vlina
an alternative of a disjunction	vlina_2
another alternative of a disjunction	vlina_3
a condition for having power	vlipa_3
powerful	vlipa
something brought about by power	vlipa_2
something with power	vlipa_1
a flyer	vofli
a means of flying	vofli_2
a voice	voksa
something with a voice	voksa_2
a doorway	vorme
a structure with a doorway	vorme_4
something a doorway is between	vorme_3
something divided by a doorway	vorme_2
a fulcrum of a lever	vraga_3
a lever	vraga
an arm of a lever	vraga_4
a purpose of a lever	vraga_2
a medium of a recording	vreji_4
a record	vreji
a subject of a recording	vreji_3
something recorded	vreji_2
a rester	vreta
something rested on	vreta_2
a property of being miscellaneous	vrici_2
something miscellaneous	vrici
a standard of virtue	vrude_2
something virtuous	vrude
a taste	vrusi
something with a taste	vrusi_2
a Ukrainian aspect	vukro_2
something Ukrainian	vukro
a dweller	xabju
a dwelling	xabju_2
a half	xadba
a standard for half	xadba_3
something halved	xadba_2
a body	xadni
something with a body	xadni_2
a subject of hunger	xagji_2
something hungry	xagji
a reed instrument	xagri
a reed of a reed instrument	xagri_2
attacked website	xaicku
damaged book	xaicku
an aspect of funniness	xajmi_3
something funny	xajmi
something to which something is funny	xajmi_2
a consumer	xaksu
something consumed	xaksu_2
a subject of flippancy	xalbo_2
something flippant	xalbo
a quantity of alcohol	xalka
a source of alcohol	xalka_3
a type of alcohol	xalka_2
something panicked about	xalni_2
something panicking	xalni
a standard of goodness	xamgu_3
something for which something is good	xamgu_2
something good	xamgu
a number of amperes	xampo_2
a standard of amperes	xampo_3
something measured in amperes	xampo_1
the number of amperes	xampo_2
a fluid of a sea	xamsi_3
a planet with a sea	xamsi_2
a sea	xamsi
a hand	xance
something with a hand	xance_2
a conditions of anxiety	xanka_3
anxious	xanka
someone anxious	xanka_1
something about which something is anxious	xanka_2
something anxious	xanka
an imaginer	xanri_2
something imagined	xanri
an elephant	xanto
a species of elephant	xanto_2
a weapon	xarci
a weapon user	xarci_3
something a weapon is used against	xarci_2
a pig	xarju
a species of pig	xarju_2
a subject of stubbornness	xarnu_3
something stubborn	xarnu
something stubbornly opposed	xarnu_2
a donkey	xasli
a species of donkey	xasli_2
a sweating gland	xasne_3
something sweating	xasne_2
sweat	xasne
a content of a letter	xatra_4
a letter	xatra
an audience for a letter	xatra_2
an author of a letter	xatra_3
a 10 to the negative eighteenth	xatsi
a 10 to the negative eighteenth aspect	xatsi_3
something with 10 to the negative eighteenths	xatsi_2
an Asiatic aspect	xazdo_2
something Asiatic	xazdo
a hater	xebni
something hated	xebni_2
a Hebrew aspect	xebro_2
something Hebrew	xebro
a hundred	xecto
a hundreds aspect	xecto_3
something with hundreds	xecto_2
a jaw	xedja
something with a jaw	xedja_2
something black	xekri
a Greek aspect	xelso_2
something Greek	xelso
an act of kindness	xendo_3
something kind	xendo
something to which something is kind	xendo_2
a regretter	xenru
something regretted	xenru_2
a 10 to the eighteenth	xexso
a 10 to the eighteenth aspect	xexso_3
something with 10 to the eighteenths	xexso_2
a Hindi aspect	xindo_2
something Hindi	xindo
a colour of ink	xinmo_2
a quantity of ink	xinmo
a writing device using ink	xinmo_3
a horse	xirma
a species of horse	xirma_2
a material of a wheel	xislu_3
a wheel	xislu
something with a wheel	xislu_2
a Hispanic aspect	xispo_2
something Hispanic	xispo
a standard of badness	xlali_3
something bad	xlali
something for which something is bad	xlali_2
a lure	xlura_4
a lurer	xlura
something lured	xlura_2
something that something is lured into	xlura_3
Xorban	xorbo
a hotel	xotli
a location of a hotel	xotli_2
an operator of a hotel	xotli_3
an Arabic aspect	xrabo_2
something Arabic	xrabo
an injury	xrani_4
a property of injury	xrani_3
something causing injury	xrani
something injured	xrani_2
a Christian aspect	xriso_2
something Christian	xriso
a quantity of buckwheat	xruba
a species of buckwheat	xruba_2
a species of turkey	xruki_2
a turkey	xruki
a flower	xrula
a flowering plant	xrula_2
a returner	xruti
something returned	xruti_2
something that something is returned from	xruti_4
something that something is returned to	xruti_3
a chemical	xukmi
a purity of chemical	xukmi_3
a type of chemical	xukmi_2
a red	xunre
an Urdu aspect	xurdo_2
something Urdu	xurdo
a claim	xusra_2
a claimant	xusra
something smooth	xutla
a favourable sense	zabna
favorable	zabna_1
property of coolness	zabna_2
something using a favourable sense	zabna_3
something with a favourable sense	zabna_2
standard of coolness	zabna_3
a gymnast	zajba
a gymnastic feat	zajba_2
a grinder	zalvi
a powder produced by griding	zalvi_3
something ground	zalvi_2
an approver	zanru
something approved of	zanru_2
a market	zarci
an operator of a market	zarci_3
something sold at a market	zarci_2
a buttocks	zargu
something with a buttocks	zargu_2
a property of temporariness	zasni_2
a standard of temporariness	zasni_3
something temporary	zasni_1
the property of temporariness	zasni_2
a metaphysics of existence	zasti_3
something existing	zasti
something to which something exists	zasti_2
a composition of soap	zbabu_3
a quantity of soap	zbabu
a source of soap	zbabu_2
a bay	zbani
a shoreline with bay	zbani_2
a maker	zbasu
a part used to make something	zbasu_3
something made	zbasu_2
a material of a pedestal	zbepi_3
a pedestal	zbepi
something supported by pedestal	zbepi_2
a home	zdani
something with a home	zdani_2
a property of amusement	zdile_3
something amused	zdile_2
something amusing	zdile
a crime	zekri
something to which something is a crime	zekri_2
an amount of increase	zenba_3
something increasing	zenba
something in which something increases	zenba_2
a 10 to the negative twenty-first	zepti
a 10 to the negative twenty-first aspect	zepti_3
something with 10 to the negative twenty-firsts	zepti_2
a 10 to the twenty-first	zetro
a 10 to the twenty-first aspect	zetro_3
something with 10 to the twenty-firsts	zetro_2
a condition of observation	zgana_4
a means of observation	zgana_3
an observeer	zgana
observe	zgana
observed	zgana_2
observer	zgana_1
something observed	zgana_2
the means of observation	zgana_3
a performer of music	zgike_2
music	zgike
a condition of liberty	zifre_3
at liberty to do	zifre
something allowed by a liberty	zifre_2
something at liberty	zifre_1
a quantity of zinc	zinki
something purple	zirpu
an expected profit of an investment	zivle_4
an invester	zivle
something invested	zivle_2
something invested in	zivle_3
an amount of exceeding	zmadu_4
a property of exceeding	zmadu_3
a condition of automation	zmiku_3
an automatic function	zmiku_2
automatic	zmiku
something automatic	zmiku_1
the automatic function	zmiku_2
an action taken	zukte_2
a purpose of an action taken	zukte_3
a taker of action	zukte
a quantity of maize	zumri
a species of maize	zumri_2
a cause of guilt	zungi_2
a feeler of  guilt	zungi
a frame of reference in which something is to the left	zunle_3
something to the left of something	zunle
something to which something is left of	zunle_2
a hinderer	zunti
a quality in which something hinders	zunti_3
something hindered	zunti_2
a sitter	zutse
a surface sat on	zutse_2
a location something is present at	zvati_2
something which is present	zvati
